gameID,id1,fgt1,fga1,fgp1,tpt1,tpa1,tpp1,ftt1,fta1,ftp1,rbt1,rbo1,rbd1,assists1,steals1,blocks1,turnovers1,personal_fouls1,id2,fgt2,fga2,fgp2,tpt2,tpa2,tpp2,ftt2,fta2,ftp2,rbt2,rbo2,rbd2,assists2,steals2,blocks2,turnovers2,personal_fouls2
372186,149,42,95,44,11,35,31,16,22,72,56,11,45,28,7,12,16,20,149,42,95,44,11,35,31,16,22,72,56,11,45,28,7,12,16,20
372187,138,35,94,37,14,46,30,12,17,70,51,15,36,19,8,6,20,15,138,35,94,37,14,46,30,12,17,70,51,15,36,19,8,6,20,15
372188,141,46,98,46,17,48,35,16,25,64,61,11,50,27,11,8,19,20,141,46,98,46,17,48,35,16,25,64,61,11,50,27,11,8,19,20
372189,148,41,85,48,10,33,30,13,16,81,46,7,39,28,8,8,17,13,148,41,85,48,10,33,30,13,16,81,46,7,39,28,8,8,17,13
372191,133,37,85,43,14,38,36,26,34,76,49,12,37,19,8,6,16,21,133,37,85,43,14,38,36,26,34,76,49,12,37,19,8,6,16,21
372193,159,39,75,52,10,29,34,24,32,75,48,8,40,30,13,2,29,29,159,39,75,52,10,29,34,24,32,75,48,8,40,30,13,2,29,29
372194,144,36,92,39,7,26,26,17,19,89,42,13,29,18,11,8,12,21,144,36,92,39,7,26,26,17,19,89,42,13,29,18,11,8,12,21
372195,151,38,84,45,13,42,31,25,33,75,39,9,30,24,7,7,13,17,151,38,84,45,13,42,31,25,33,75,39,9,30,24,7,7,13,17
372196,152,41,98,41,13,38,34,27,34,79,52,16,36,26,6,7,13,17,152,41,98,41,13,38,34,27,34,79,52,16,36,26,6,7,13,17
372197,145,47,98,48,20,55,36,15,19,78,48,8,40,25,8,6,15,27,145,47,98,48,20,55,36,15,19,78,48,8,40,25,8,6,15,27
372198,132,37,85,43,12,41,29,22,25,88,50,10,40,22,9,2,20,16,132,37,85,43,12,41,29,22,25,88,50,10,40,22,9,2,20,16
372199,147,38,92,41,12,38,31,25,27,92,51,8,43,23,10,6,19,25,147,38,92,41,12,38,31,25,27,92,51,8,43,23,10,6,19,25
372200,142,42,90,46,10,25,40,28,39,71,56,14,42,23,10,5,11,23,142,42,90,46,10,25,40,28,39,71,56,14,42,23,10,5,11,23
372201,146,39,93,41,13,45,28,17,22,77,49,9,40,27,5,11,17,20,146,39,93,41,13,45,28,17,22,77,49,9,40,27,5,11,17,20
372202,150,39,95,41,8,34,23,19,29,65,54,17,37,20,9,7,17,22,150,39,95,41,8,34,23,19,29,65,54,17,37,20,9,7,17,22
372203,144,36,93,38,10,36,27,21,24,87,51,15,36,22,11,11,15,21,144,36,93,38,10,36,27,21,24,87,51,15,36,22,11,11,15,21
372204,155,36,77,46,14,35,40,21,28,75,38,7,31,29,6,7,15,16,155,36,77,46,14,35,40,21,28,75,38,7,31,29,6,7,15,16
372205,154,36,84,42,16,44,36,13,17,76,37,9,28,24,12,4,13,20,154,36,84,42,16,44,36,13,17,76,37,9,28,24,12,4,13,20
372206,145,41,82,50,10,30,33,17,22,77,47,4,43,25,6,4,20,17,145,41,82,50,10,30,33,17,22,77,47,4,43,25,6,4,20,17
372207,137,37,84,44,17,44,38,14,19,73,45,9,36,28,5,4,20,24,137,37,84,44,17,44,38,14,19,73,45,9,36,28,5,4,20,24
372208,152,38,91,41,17,43,39,32,39,82,39,14,25,25,11,5,11,20,152,38,91,41,17,43,39,32,39,82,39,14,25,25,11,5,11,20
372209,161,33,95,34,9,41,22,23,27,85,48,10,38,23,11,12,15,23,161,33,95,34,9,41,22,23,27,85,48,10,38,23,11,12,15,23
372210,132,40,91,44,16,42,38,7,12,58,41,7,34,29,16,5,21,21,132,40,91,44,16,42,38,7,12,58,41,7,34,29,16,5,21,21
372212,150,32,83,38,13,37,35,10,15,66,36,12,24,21,12,6,25,18,150,32,83,38,13,37,35,10,15,66,36,12,24,21,12,6,25,18
372213,156,42,88,47,14,35,40,13,16,81,35,7,28,28,6,3,15,19,156,42,88,47,14,35,40,13,16,81,35,7,28,28,6,3,15,19
372214,158,43,81,53,16,35,45,18,25,72,35,6,29,29,10,9,13,14,158,43,81,53,16,35,45,18,25,72,35,6,29,29,10,9,13,14
372215,145,43,85,50,16,36,44,23,37,62,41,9,32,30,13,6,17,19,145,43,85,50,16,36,44,23,37,62,41,9,32,30,13,6,17,19
372216,132,42,88,47,9,42,21,17,20,85,46,10,36,28,15,3,23,17,132,42,88,47,9,42,21,17,20,85,46,10,36,28,15,3,23,17
372217,151,38,80,47,13,36,36,23,30,76,40,9,31,22,13,2,16,19,151,38,80,47,13,36,36,23,30,76,40,9,31,22,13,2,16,19
372218,160,42,74,56,15,29,51,39,44,88,38,6,32,33,11,4,19,20,160,42,74,56,15,29,51,39,44,88,38,6,32,33,11,4,19,20
372219,135,46,88,52,12,38,31,13,22,59,43,8,35,28,10,7,12,15,135,46,88,52,12,38,31,13,22,59,43,8,35,28,10,7,12,15
372220,147,52,91,57,13,33,39,15,18,83,47,9,38,30,3,5,14,21,147,52,91,57,13,33,39,15,18,83,47,9,38,30,3,5,14,21
372221,145,34,90,37,9,34,26,20,27,74,47,11,36,23,12,10,15,21,145,34,90,37,9,34,26,20,27,74,47,11,36,23,12,10,15,21
372222,139,39,74,52,14,40,35,24,36,66,39,5,34,25,4,9,11,18,139,39,74,52,14,40,35,24,36,66,39,5,34,25,4,9,11,18
372224,143,42,86,48,18,49,36,14,18,77,37,7,30,36,5,8,12,26,143,42,86,48,18,49,36,14,18,77,37,7,30,36,5,8,12,26
372225,134,39,81,48,17,31,54,24,30,80,47,8,39,33,6,7,27,18,134,39,81,48,17,31,54,24,30,80,47,8,39,33,6,7,27,18
372226,158,32,87,36,11,34,32,14,27,51,49,10,39,21,10,9,18,22,158,32,87,36,11,34,32,14,27,51,49,10,39,21,10,9,18,22
372227,155,39,88,44,9,26,34,30,35,85,47,15,32,25,15,7,23,22,155,39,88,44,9,26,34,30,35,85,47,15,32,25,15,7,23,22
372228,153,35,84,41,13,47,27,9,15,60,39,10,29,27,11,10,19,15,153,35,84,41,13,47,27,9,15,60,39,10,29,27,11,10,19,15
372229,133,42,91,46,23,52,44,16,20,80,46,13,33,26,8,4,15,14,133,42,91,46,23,52,44,16,20,80,46,13,33,26,8,4,15,14
372230,136,42,95,44,9,26,34,9,11,81,43,14,29,26,9,7,23,26,136,42,95,44,9,26,34,9,11,81,43,14,29,26,9,7,23,26
372231,152,48,85,56,18,39,46,10,17,58,46,3,43,34,10,3,19,15,152,48,85,56,18,39,46,10,17,58,46,3,43,34,10,3,19,15
372232,144,46,82,56,10,28,35,14,20,70,49,10,39,28,6,6,16,22,144,46,82,56,10,28,35,14,20,70,49,10,39,28,6,6,16,22
372233,151,40,92,43,14,39,35,12,21,57,47,14,33,20,5,0,15,17,151,40,92,43,14,39,35,12,21,57,47,14,33,20,5,0,15,17
372234,147,41,98,41,11,33,33,11,13,84,53,15,38,27,4,3,16,24,147,41,98,41,11,33,33,11,13,84,53,15,38,27,4,3,16,24
372235,158,39,83,47,13,35,37,26,34,76,54,10,44,33,9,4,23,26,158,39,83,47,13,35,37,26,34,76,54,10,44,33,9,4,23,26
372236,141,45,88,51,16,31,51,10,15,66,47,7,40,31,8,3,22,21,141,45,88,51,16,31,51,10,15,66,47,7,40,31,8,3,22,21
372237,135,37,88,42,4,28,14,21,26,80,49,10,39,24,8,5,24,17,135,37,88,42,4,28,14,21,26,80,49,10,39,24,8,5,24,17
372238,136,35,81,43,11,36,30,24,27,88,34,7,27,25,11,4,14,20,136,35,81,43,11,36,30,24,27,88,34,7,27,25,11,4,14,20
372239,152,43,90,47,9,32,28,21,32,65,45,6,39,28,10,5,14,29,152,43,90,47,9,32,28,21,32,65,45,6,39,28,10,5,14,29
372240,144,35,86,40,4,24,16,16,26,61,46,12,34,18,11,2,17,20,144,35,86,40,4,24,16,16,26,61,46,12,34,18,11,2,17,20
372241,145,35,76,46,11,29,37,19,27,70,36,6,30,19,11,13,22,27,145,35,76,46,11,29,37,19,27,70,36,6,30,19,11,13,22,27
372242,157,42,95,44,18,46,39,14,17,82,50,12,38,28,4,7,14,22,157,42,95,44,18,46,39,14,17,82,50,12,38,28,4,7,14,22
372243,154,41,80,51,17,40,42,21,28,75,40,10,30,31,12,6,20,21,154,41,80,51,17,40,42,21,28,75,40,10,30,31,12,6,20,21
372244,143,37,84,44,13,34,38,22,28,78,54,8,46,26,13,6,26,17,143,37,84,44,13,34,38,22,28,78,54,8,46,26,13,6,26,17
372245,159,49,95,51,16,40,40,20,27,74,60,14,46,36,6,10,15,26,159,49,95,51,16,40,40,20,27,74,60,14,46,36,6,10,15,26
372247,142,39,89,43,8,28,28,24,28,85,49,13,36,22,12,6,17,23,142,39,89,43,8,28,28,24,28,85,49,13,36,22,12,6,17,23
372248,148,46,98,46,17,51,33,15,25,60,50,15,35,31,10,7,14,19,148,46,98,46,17,51,33,15,25,60,50,15,35,31,10,7,14,19
372246,138,39,91,42,17,40,42,19,23,82,50,8,42,30,8,8,12,13,138,39,91,42,17,40,42,19,23,82,50,8,42,30,8,8,12,13
372249,141,42,93,45,14,46,30,19,25,76,52,17,35,28,10,5,18,19,141,42,93,45,14,46,30,19,25,76,52,17,35,28,10,5,18,19
372250,139,48,91,52,14,34,41,9,12,75,42,9,33,29,9,6,11,15,139,48,91,52,14,34,41,9,12,75,42,9,33,29,9,6,11,15
372251,141,36,101,35,10,43,23,22,28,78,49,18,31,19,11,6,11,23,141,36,101,35,10,43,23,22,28,78,49,18,31,19,11,6,11,23
372252,153,42,87,48,9,34,26,23,26,88,57,17,40,19,8,5,16,20,153,42,87,48,9,34,26,23,26,88,57,17,40,19,8,5,16,20
372253,143,56,107,52,20,43,46,11,12,91,51,10,41,38,10,8,12,23,143,56,107,52,20,43,46,11,12,91,51,10,41,38,10,8,12,23
372254,151,36,97,37,18,41,43,14,26,53,47,17,30,24,9,0,11,22,151,36,97,37,18,41,43,14,26,53,47,17,30,24,9,0,11,22
372255,135,43,86,50,11,37,29,19,26,73,51,12,39,34,5,3,19,21,135,43,86,50,11,37,29,19,26,73,51,12,39,34,5,3,19,21
372258,159,36,90,40,14,35,40,11,16,68,47,8,39,27,9,11,14,18,159,36,90,40,14,35,40,11,16,68,47,8,39,27,9,11,14,18
372256,134,42,84,50,9,27,33,20,26,76,50,13,37,30,6,6,18,16,134,42,84,50,9,27,33,20,26,76,50,13,37,30,6,6,18,16
372257,147,37,92,40,8,22,36,21,26,80,48,16,32,22,11,3,7,18,147,37,92,40,8,22,36,21,26,80,48,16,32,22,11,3,7,18
372259,136,39,94,41,12,42,28,14,18,77,42,13,29,26,10,3,13,16,136,39,94,41,12,42,28,14,18,77,42,13,29,26,10,3,13,16
372260,146,38,91,41,12,43,27,16,20,80,37,8,29,23,8,7,13,19,146,38,91,41,12,43,27,16,20,80,37,8,29,23,8,7,13,19
372261,160,41,91,45,9,28,32,23,31,74,54,16,38,22,6,2,14,20,160,41,91,45,9,28,32,23,31,74,54,16,38,22,6,2,14,20
372262,158,46,89,51,11,35,31,16,22,72,45,9,36,33,8,5,19,23,158,46,89,51,11,35,31,16,22,72,45,9,36,33,8,5,19,23
372263,144,47,90,52,16,34,47,13,16,81,45,14,31,36,11,7,18,20,144,47,90,52,16,34,47,13,16,81,45,14,31,36,11,7,18,20
372264,148,41,82,50,11,30,36,25,36,69,44,9,35,20,9,4,14,23,148,41,82,50,11,30,36,25,36,69,44,9,35,20,9,4,14,23
372265,145,36,84,42,5,29,17,23,29,79,42,8,34,24,14,7,16,23,145,36,84,42,5,29,17,23,29,79,42,8,34,24,14,7,16,23
372267,146,37,85,43,10,33,30,20,24,83,48,13,35,22,13,7,21,23,146,37,85,43,10,33,30,20,24,83,48,13,35,22,13,7,21,23
372266,135,33,88,37,7,28,25,26,34,76,41,11,30,20,13,7,18,23,135,33,88,37,7,28,25,26,34,76,41,11,30,20,13,7,18,23
372269,133,45,95,47,16,39,41,13,19,68,55,16,39,20,7,6,15,19,133,45,95,47,16,39,41,13,19,68,55,16,39,20,7,6,15,19
372270,137,38,92,41,12,45,26,17,23,73,48,8,40,20,10,8,14,16,137,38,92,41,12,45,26,17,23,73,48,8,40,20,10,8,14,16
372268,132,42,87,48,12,32,37,24,30,80,44,9,35,28,8,6,14,20,132,42,87,48,12,32,37,24,30,80,44,9,35,28,8,6,14,20
372273,138,44,91,48,15,36,41,22,28,78,40,8,32,20,5,2,9,15,138,44,91,48,15,36,41,22,28,78,40,8,32,20,5,2,9,15
372274,160,42,96,43,16,41,39,20,22,90,45,17,28,27,7,4,14,24,160,42,96,43,16,41,39,20,22,90,45,17,28,27,7,4,14,24
372275,156,35,88,39,9,32,28,18,21,85,47,15,32,15,6,1,16,24,156,35,88,39,9,32,28,18,21,85,47,15,32,15,6,1,16,24
372276,157,41,94,43,12,40,30,20,29,69,41,10,31,24,10,3,14,16,157,41,94,43,12,40,30,20,29,69,41,10,31,24,10,3,14,16
372277,140,45,86,52,12,28,42,16,20,80,53,15,38,29,4,4,15,18,140,45,86,52,12,28,42,16,20,80,53,15,38,29,4,4,15,18
372278,150,40,87,46,9,33,27,7,16,43,43,4,39,20,8,5,13,22,150,40,87,46,9,33,27,7,16,43,43,4,39,20,8,5,13,22
372279,161,40,93,43,16,46,34,17,22,77,45,11,34,25,9,5,11,15,161,40,93,43,16,46,34,17,22,77,45,11,34,25,9,5,11,15
372281,137,43,100,43,12,31,38,15,24,62,52,19,33,29,2,6,6,16,137,43,100,43,12,31,38,15,24,62,52,19,33,29,2,6,6,16
372280,159,38,87,43,17,32,53,14,19,73,41,13,28,28,5,5,13,19,159,38,87,43,17,32,53,14,19,73,41,13,28,28,5,5,13,19
372282,149,44,86,51,12,34,35,6,8,75,47,7,40,30,9,3,14,17,149,44,86,51,12,34,35,6,8,75,47,7,40,30,9,3,14,17
372283,155,45,85,52,10,37,27,26,28,92,39,7,32,31,10,7,11,19,155,45,85,52,10,37,27,26,28,92,39,7,32,31,10,7,11,19
372284,152,37,90,41,6,32,18,15,18,83,29,7,22,22,8,4,10,14,152,37,90,41,6,32,18,15,18,83,29,7,22,22,8,4,10,14
372285,142,34,90,37,9,33,27,18,19,94,42,10,32,22,7,4,7,20,142,34,90,37,9,33,27,18,19,94,42,10,32,22,7,4,7,20
372286,148,39,86,45,16,44,36,16,20,80,39,12,27,22,10,3,23,22,148,39,86,45,16,44,36,16,20,80,39,12,27,22,10,3,23,22
372287,154,40,82,48,11,28,39,35,40,87,51,11,40,28,10,17,16,20,154,40,82,48,11,28,39,35,40,87,51,11,40,28,10,17,16,20
372288,144,47,91,51,16,42,38,13,21,61,48,9,39,23,15,5,16,16,144,47,91,51,16,42,38,13,21,61,48,9,39,23,15,5,16,16
372292,143,36,88,40,12,46,26,21,25,84,47,11,36,26,7,5,17,24,143,36,88,40,12,46,26,21,25,84,47,11,36,26,7,5,17,24
372290,161,39,87,44,11,36,30,18,26,69,40,11,29,26,12,4,15,13,161,39,87,44,11,36,30,18,26,69,40,11,29,26,12,4,15,13
372291,135,47,96,49,8,31,25,19,20,95,39,8,31,33,8,5,10,23,135,47,96,49,8,31,25,19,20,95,39,8,31,33,8,5,10,23
372293,132,48,86,55,14,30,46,17,18,94,36,4,32,28,6,7,11,12,132,48,86,55,14,30,46,17,18,94,36,4,32,28,6,7,11,12
372294,159,38,94,40,4,29,13,11,15,73,47,14,33,19,10,4,12,17,159,38,94,40,4,29,13,11,15,73,47,14,33,19,10,4,12,17
372295,146,42,92,45,14,37,37,12,20,60,44,10,34,22,9,4,12,22,146,42,92,45,14,37,37,12,20,60,44,10,34,22,9,4,12,22
372296,148,44,87,50,12,37,32,22,30,73,43,9,34,24,8,5,15,23,148,44,87,50,12,37,32,22,30,73,43,9,34,24,8,5,15,23
372297,150,38,93,40,10,39,25,16,26,61,39,14,25,23,8,3,11,18,150,38,93,40,10,39,25,16,26,61,39,14,25,23,8,3,11,18
372298,152,44,83,53,13,29,44,23,28,82,44,6,38,21,9,10,15,19,152,44,83,53,13,29,44,23,28,82,44,6,38,21,9,10,15,19
372299,139,47,84,56,9,28,32,7,17,41,43,7,36,32,4,8,13,14,139,47,84,56,9,28,32,7,17,41,43,7,36,32,4,8,13,14
372300,145,42,79,53,8,27,29,14,18,77,40,3,37,28,7,10,16,17,145,42,79,53,8,27,29,14,18,77,40,3,37,28,7,10,16,17
372301,137,36,92,39,10,38,26,9,12,75,46,14,32,19,6,6,15,19,137,36,92,39,10,38,26,9,12,75,46,14,32,19,6,6,15,19
372302,155,42,83,50,18,39,46,12,15,80,43,6,37,29,8,7,19,18,155,42,83,50,18,39,46,12,15,80,43,6,37,29,8,7,19,18
372303,144,44,89,49,14,31,45,16,23,69,44,9,35,29,10,4,16,26,144,44,89,49,14,31,45,16,23,69,44,9,35,29,10,4,16,26
372304,140,40,90,44,11,29,37,10,11,90,38,6,32,24,12,4,18,31,140,40,90,44,11,29,37,10,11,90,38,6,32,24,12,4,18,31
372305,159,51,91,56,15,38,39,13,14,92,50,15,35,35,7,7,16,25,159,51,91,56,15,38,39,13,14,92,50,15,35,35,7,7,16,25
372309,133,54,95,56,20,35,57,27,28,96,57,11,46,27,5,2,11,19,133,54,95,56,20,35,57,27,28,96,57,11,46,27,5,2,11,19
372308,147,39,91,42,13,38,34,14,18,77,46,11,35,22,10,5,16,20,147,39,91,42,13,38,34,14,18,77,46,11,35,22,10,5,16,20
372310,132,46,92,50,9,32,28,29,32,90,57,14,43,26,8,3,20,16,132,46,92,50,9,32,28,29,32,90,57,14,43,26,8,3,20,16
372306,151,32,92,34,5,30,16,20,30,66,50,16,34,18,10,3,13,16,151,32,92,34,5,30,16,20,30,66,50,16,34,18,10,3,13,16
372307,152,38,88,43,7,34,20,23,25,92,49,6,43,23,6,5,14,24,152,38,88,43,7,34,20,23,25,92,49,6,43,23,6,5,14,24
372312,149,38,83,45,8,21,38,26,27,96,47,8,39,20,9,5,13,15,149,38,83,45,8,21,38,26,27,96,47,8,39,20,9,5,13,15
372311,142,44,84,52,21,37,56,19,23,82,38,7,31,35,10,2,17,22,142,44,84,52,21,37,56,19,23,82,38,7,31,35,10,2,17,22
372313,138,37,81,45,20,48,41,20,28,71,45,13,32,23,7,2,13,11,138,37,81,45,20,48,41,20,28,71,45,13,32,23,7,2,13,11
372314,160,47,87,54,22,43,51,17,24,70,50,10,40,35,7,3,21,22,160,47,87,54,22,43,51,17,24,70,50,10,40,35,7,3,21,22
372315,141,39,81,48,11,31,35,13,15,86,36,7,29,32,5,6,17,17,141,39,81,48,11,31,35,13,15,86,36,7,29,32,5,6,17,17
372317,154,42,92,45,9,25,36,21,25,84,46,15,31,21,12,3,14,19,154,42,92,45,9,25,36,21,25,84,46,15,31,21,12,3,14,19
372318,150,39,80,48,14,32,43,33,35,94,36,7,29,27,5,7,12,18,150,39,80,48,14,32,43,33,35,94,36,7,29,27,5,7,12,18
372319,160,41,89,46,12,33,36,19,26,73,48,13,35,27,9,7,20,27,160,41,89,46,12,33,36,19,26,73,48,13,35,27,9,7,20,27
372320,155,43,80,53,16,32,50,19,26,73,34,5,29,26,5,4,14,15,155,43,80,53,16,32,50,19,26,73,34,5,29,26,5,4,14,15
362177,143,45,86,52,15,31,48,16,24,66,40,7,33,28,7,5,19,18,143,45,86,52,15,31,48,16,24,66,40,7,33,28,7,5,19,18
362178,148,35,82,42,20,39,51,20,28,71,41,7,34,24,6,10,14,16,148,35,82,42,20,39,51,20,28,71,41,7,34,24,6,10,14,16
362179,136,43,89,48,11,28,39,10,14,71,42,9,33,21,4,4,10,13,136,43,89,48,11,28,39,10,14,71,42,9,33,21,4,4,10,13
362180,147,48,80,60,13,27,48,12,14,85,37,7,30,35,9,1,21,18,147,48,80,60,13,27,48,12,14,85,37,7,30,35,9,1,21,18
362181,152,50,83,60,15,29,51,24,30,80,32,7,25,26,3,1,19,20,152,50,83,60,15,29,51,24,30,80,32,7,25,26,3,1,19,20
362182,139,49,93,52,13,30,43,14,19,73,51,19,32,33,11,6,20,17,139,49,93,52,13,30,43,14,19,73,51,19,32,33,11,6,20,17
372321,154,43,90,47,11,30,36,15,18,83,51,15,36,24,5,6,17,24,154,43,90,47,11,30,36,15,18,83,51,15,36,24,5,6,17,24
372322,143,45,93,48,22,45,48,12,16,75,36,11,25,31,7,5,15,18,143,45,93,48,22,45,48,12,16,75,36,11,25,31,7,5,15,18
372323,150,40,84,47,8,31,25,17,21,81,35,9,26,24,9,7,11,15,150,40,84,47,8,31,25,17,21,81,35,9,26,24,9,7,11,15
372324,153,46,101,45,12,33,36,16,19,84,51,19,32,29,6,9,16,18,153,46,101,45,12,33,36,16,19,84,51,19,32,29,6,9,16,18
372327,149,45,81,55,9,24,37,24,31,77,43,9,34,25,10,11,11,23,149,45,81,55,9,24,37,24,31,77,43,9,34,25,10,11,11,23
372325,134,43,100,43,17,52,32,11,17,64,42,10,32,22,4,5,6,21,134,43,100,43,17,52,32,11,17,64,42,10,32,22,4,5,6,21
372326,142,40,87,46,13,36,36,14,20,70,53,10,43,28,4,3,11,18,142,40,87,46,13,36,36,14,20,70,53,10,43,28,4,3,11,18
372328,139,42,81,51,16,36,44,23,30,76,49,10,39,31,10,4,11,18,139,42,81,51,16,36,44,23,30,76,49,10,39,31,10,4,11,18
372329,140,43,87,49,8,23,34,12,14,85,33,10,23,25,7,6,16,23,140,43,87,49,8,23,34,12,14,85,33,10,23,25,7,6,16,23
372331,137,41,83,49,11,37,29,22,28,78,54,13,41,26,8,2,18,21,137,41,83,49,11,37,29,22,28,78,54,13,41,26,8,2,18,21
372332,138,43,91,47,14,42,33,24,32,75,47,9,38,31,3,6,11,19,138,43,91,47,14,42,33,24,32,75,47,9,38,31,3,6,11,19
372333,156,37,95,38,14,45,31,12,15,80,47,16,31,23,11,5,14,21,156,37,95,38,14,45,31,12,15,80,47,16,31,23,11,5,14,21
372336,153,40,85,47,8,27,29,14,18,77,38,6,32,27,6,4,21,24,153,40,85,47,8,27,29,14,18,77,38,6,32,27,6,4,21,24
372334,140,38,80,47,13,30,43,20,21,95,39,7,32,23,8,2,16,20,140,38,80,47,13,30,43,20,21,95,39,7,32,23,8,2,16,20
372335,143,55,95,57,20,38,52,22,23,95,49,9,40,38,7,4,15,24,143,55,95,57,20,38,52,22,23,95,49,9,40,38,7,4,15,24
372337,154,51,91,56,12,31,38,32,36,88,45,10,35,37,12,7,16,15,154,51,91,56,12,31,38,32,36,88,45,10,35,37,12,7,16,15
372338,151,41,88,46,12,31,38,17,18,94,48,18,30,28,13,1,20,13,151,41,88,46,12,31,38,17,18,94,48,18,30,28,13,1,20,13
372339,147,41,88,46,12,37,32,14,16,87,44,11,33,30,11,4,18,14,147,41,88,46,12,37,32,14,16,87,44,11,33,30,11,4,18,14
372340,134,49,101,48,16,45,35,11,13,84,46,11,35,22,2,4,8,16,134,49,101,48,16,45,35,11,13,84,46,11,35,22,2,4,8,16
372344,152,45,94,47,14,35,40,22,23,95,49,11,38,27,7,7,13,22,152,45,94,47,14,35,40,22,23,95,49,11,38,27,7,7,13,22
372341,136,48,93,51,18,34,52,16,19,84,36,10,26,26,12,3,8,18,136,48,93,51,18,34,52,16,19,84,36,10,26,26,12,3,8,18
372342,142,43,75,57,15,31,48,21,27,77,39,5,34,28,8,4,11,19,142,43,75,57,15,31,48,21,27,77,39,5,34,28,8,4,11,19
372345,139,51,95,53,15,39,38,17,23,73,45,11,34,37,6,5,10,16,139,51,95,53,15,39,38,17,23,73,45,11,34,37,6,5,10,16
372347,143,52,101,51,13,41,31,17,20,85,46,14,32,26,14,7,11,15,143,52,101,51,13,41,31,17,20,85,46,14,32,26,14,7,11,15
372346,135,41,79,51,8,25,32,26,35,74,47,11,36,17,8,5,22,22,135,41,79,51,8,25,32,26,35,74,47,11,36,17,8,5,22,22
372348,154,42,95,44,9,34,26,13,15,86,56,12,44,20,7,7,14,16,154,42,95,44,9,34,26,13,15,86,56,12,44,20,7,7,14,16
372350,151,46,100,46,19,42,45,15,22,68,47,13,34,28,7,0,4,14,151,46,100,46,19,42,45,15,22,68,47,13,34,28,7,0,4,14
372349,134,37,92,40,15,41,36,11,13,84,49,14,35,22,10,10,16,14,134,37,92,40,15,41,36,11,13,84,49,14,35,22,10,10,16,14
372352,142,51,93,54,14,33,42,12,19,63,57,14,43,26,4,3,13,23,142,51,93,54,14,33,42,12,19,63,57,14,43,26,4,3,13,23
372353,146,35,90,38,11,37,29,21,28,75,38,13,25,20,10,4,14,27,146,35,90,38,11,37,29,21,28,75,38,13,25,20,10,4,14,27
372354,148,41,90,45,11,37,29,27,32,84,36,5,31,19,8,7,10,18,148,41,90,45,11,37,29,27,32,84,36,5,31,19,8,7,10,18
372355,149,45,82,54,15,37,40,17,24,70,48,8,40,30,9,7,18,23,149,45,82,54,15,37,40,17,24,70,48,8,40,30,9,7,18,23
372356,152,44,86,51,12,28,42,28,30,93,41,12,29,23,10,8,14,27,152,44,86,51,12,28,42,28,30,93,41,12,29,23,10,8,14,27
372357,138,40,84,47,17,41,41,19,31,61,38,6,32,25,4,6,16,21,138,40,84,47,17,41,41,19,31,61,38,6,32,25,4,6,16,21
372359,139,41,92,44,11,35,31,15,22,68,45,10,35,24,7,4,6,20,139,41,92,44,11,35,31,15,22,68,45,10,35,24,7,4,6,20
372360,143,44,92,47,20,48,41,18,20,90,40,9,31,27,6,6,13,25,143,44,92,47,20,48,41,18,20,90,40,9,31,27,6,6,13,25
372361,153,42,90,46,10,27,37,25,35,71,47,18,29,19,12,6,19,24,153,42,90,46,10,27,37,25,35,71,47,18,29,19,12,6,19,24
362184,140,40,86,46,8,28,28,18,22,81,48,11,37,28,3,5,17,26,140,40,86,46,8,28,28,18,22,81,48,11,37,28,3,5,17,26
362185,161,43,88,48,14,38,36,17,20,85,36,7,29,28,4,6,15,23,161,43,88,48,14,38,36,17,20,85,36,7,29,28,4,6,15,23
362186,133,41,94,43,19,52,36,20,28,71,52,17,35,29,5,3,8,13,133,41,94,43,19,52,36,20,28,71,52,17,35,29,5,3,8,13
362189,158,43,92,46,12,34,35,12,19,63,38,7,31,29,9,8,14,21,158,43,92,46,12,34,35,12,19,63,38,7,31,29,9,8,14,21
362187,142,36,88,40,10,35,28,22,28,78,42,9,33,20,9,5,9,22,142,36,88,40,10,35,28,22,28,78,42,9,33,20,9,5,9,22
362188,146,46,101,45,19,48,39,10,13,76,37,14,23,23,5,5,11,23,146,46,101,45,19,48,39,10,13,76,37,14,23,23,5,5,11,23
362190,138,51,98,52,19,42,45,23,26,88,41,15,26,30,7,1,9,23,138,51,98,52,19,42,45,23,26,88,41,15,26,30,7,1,9,23
362192,157,38,91,41,13,47,27,16,21,76,52,16,36,28,10,9,18,22,157,38,91,41,13,47,27,16,21,76,52,16,36,28,10,9,18,22
362191,155,42,94,44,15,37,40,20,27,74,52,17,35,22,9,1,13,24,155,42,94,44,15,37,40,20,27,74,52,17,35,22,9,1,13,24
372362,153,36,84,42,10,26,38,30,35,85,43,15,28,24,9,1,16,17,153,36,84,42,10,26,38,30,35,85,43,15,28,24,9,1,16,17
372363,133,47,86,54,15,44,34,8,13,61,46,5,41,30,1,4,13,14,133,47,86,54,15,44,34,8,13,61,46,5,41,30,1,4,13,14
372364,132,38,87,43,18,46,39,15,18,83,48,15,33,23,6,6,21,19,132,38,87,43,18,46,39,15,18,83,48,15,33,23,6,6,21,19
372365,141,37,90,41,13,38,34,23,30,76,55,15,40,26,5,3,20,29,141,37,90,41,13,38,34,23,30,76,55,15,40,26,5,3,20,29
372366,151,47,87,54,15,36,41,20,30,66,40,10,30,25,8,4,9,18,151,47,87,54,15,36,41,20,30,66,40,10,30,25,8,4,9,18
372367,134,37,98,37,12,49,24,16,20,80,66,20,46,22,6,6,19,18,134,37,98,37,12,49,24,16,20,80,66,20,46,22,6,6,19,18
372368,144,37,85,43,12,34,35,15,23,65,41,8,33,26,9,3,16,23,144,37,85,43,12,34,35,15,23,65,41,8,33,26,9,3,16,23
372369,154,53,105,50,14,33,42,17,20,85,54,23,31,28,5,7,11,15,154,53,105,50,14,33,42,17,20,85,54,23,31,28,5,7,11,15
372371,142,37,87,42,10,32,31,23,29,79,45,12,33,20,7,4,9,16,142,37,87,42,10,32,31,23,29,79,45,12,33,20,7,4,9,16
372373,158,42,91,46,19,44,43,10,12,83,50,11,39,35,3,6,17,21,158,42,91,46,19,44,43,10,12,83,50,11,39,35,3,6,17,21
372370,136,44,91,48,11,30,36,20,25,80,40,11,29,22,12,6,6,21,136,44,91,48,11,30,36,20,25,80,40,11,29,22,12,6,6,21
372372,150,47,92,51,17,36,47,13,22,59,54,13,41,31,2,3,18,20,150,47,92,51,17,36,47,13,22,59,54,13,41,31,2,3,18,20
372374,155,32,83,38,9,29,31,26,31,83,51,16,35,20,4,7,17,19,155,32,83,38,9,29,31,26,31,83,51,16,35,20,4,7,17,19
372375,141,37,96,38,12,43,27,24,28,85,51,19,32,24,9,0,14,28,141,37,96,38,12,43,27,24,28,85,51,19,32,24,9,0,14,28
372376,145,41,84,48,4,19,21,30,37,81,41,7,34,27,8,4,9,11,145,41,84,48,4,19,21,30,37,81,41,7,34,27,8,4,9,11
372378,133,40,79,50,19,43,44,15,16,93,37,8,29,27,3,3,11,22,133,40,79,50,19,43,44,15,16,93,37,8,29,27,3,3,11,22
372377,159,45,90,50,4,20,20,17,25,68,48,16,32,28,11,4,16,13,159,45,90,50,4,20,20,17,25,68,48,16,32,28,11,4,16,13
372379,148,42,89,47,15,47,31,19,27,70,53,13,40,23,3,5,17,23,148,42,89,47,15,47,31,19,27,70,53,13,40,23,3,5,17,23
372380,157,49,83,59,20,42,47,14,22,63,37,8,29,32,3,4,10,19,157,49,83,59,20,42,47,14,22,63,37,8,29,32,3,4,10,19
362194,140,47,90,52,10,29,34,16,23,69,42,14,28,36,9,6,17,20,140,47,90,52,10,29,34,16,23,69,42,14,28,36,9,6,17,20
362195,154,43,86,50,6,22,27,34,35,97,38,5,33,23,5,3,16,26,154,43,86,50,6,22,27,34,35,97,38,5,33,23,5,3,16,26
362193,135,36,81,44,15,32,46,18,22,81,45,13,32,21,6,0,18,21,135,36,81,44,15,32,46,18,22,81,45,13,32,21,6,0,18,21
362196,134,46,85,54,19,39,48,13,20,65,44,13,31,22,13,3,15,24,134,46,85,54,19,39,48,13,20,65,44,13,31,22,13,3,15,24
362197,152,46,89,51,15,39,38,16,20,80,40,4,36,34,19,6,15,17,152,46,89,51,15,39,38,16,20,80,40,4,36,34,19,6,15,17
362198,150,49,94,52,14,38,36,19,26,73,42,12,30,33,17,6,12,20,150,49,94,52,14,38,36,19,26,73,42,12,30,33,17,6,12,20
362199,160,44,95,46,13,43,30,14,15,93,52,16,36,26,11,6,12,18,160,44,95,46,13,43,30,14,15,93,52,16,36,26,11,6,12,18
362200,139,39,73,53,8,23,34,25,32,78,36,6,30,26,4,2,14,19,139,39,73,53,8,23,34,25,32,78,36,6,30,26,4,2,14,19
362201,141,37,88,42,13,39,33,14,16,87,46,13,33,28,11,2,19,22,141,37,88,42,13,39,33,14,16,87,46,13,33,28,11,2,19,22
362202,145,47,81,58,22,35,62,18,24,75,54,10,44,30,4,10,18,13,145,47,81,58,22,35,62,18,24,75,54,10,44,30,4,10,18,13
372381,161,43,89,48,12,36,33,19,23,82,46,8,38,23,6,1,12,22,161,43,89,48,12,36,33,19,23,82,46,8,38,23,6,1,12,22
372384,159,38,96,39,9,33,27,27,31,87,55,26,29,28,10,8,14,19,159,38,96,39,9,33,27,27,31,87,55,26,29,28,10,8,14,19
372383,154,39,85,45,11,30,36,18,22,81,41,10,31,18,5,1,9,14,154,39,85,45,11,30,36,18,22,81,41,10,31,18,5,1,9,14
372382,132,41,75,54,12,31,38,20,26,76,30,6,24,28,11,6,15,20,132,41,75,54,12,31,38,20,26,76,30,6,24,28,11,6,15,20
372385,136,33,83,39,9,33,27,19,22,86,53,14,39,16,7,4,19,25,136,33,83,39,9,33,27,19,22,86,53,14,39,16,7,4,19,25
372386,155,51,85,60,17,31,54,14,15,93,32,5,27,31,1,4,9,21,155,51,85,60,17,31,54,14,15,93,32,5,27,31,1,4,9,21
372387,145,42,83,50,11,29,37,15,19,78,43,7,36,25,12,6,23,17,145,42,83,50,11,29,37,15,19,78,43,7,36,25,12,6,23,17
372388,156,34,91,37,13,38,34,14,16,87,30,8,22,24,9,3,12,21,156,34,91,37,13,38,34,14,16,87,30,8,22,24,9,3,12,21
372389,147,42,81,51,15,35,42,23,24,95,32,7,25,26,8,3,9,20,147,42,81,51,15,35,42,23,24,95,32,7,25,26,8,3,9,20
372390,141,40,98,40,14,41,34,15,19,78,49,20,29,27,5,4,16,19,141,40,98,40,14,41,34,15,19,78,49,20,29,27,5,4,16,19
362203,135,37,91,40,6,26,23,19,22,86,43,9,34,18,5,2,12,14,135,37,91,40,6,26,23,19,22,86,43,9,34,18,5,2,12,14
362204,161,37,82,45,10,32,31,15,16,93,32,7,25,25,4,4,14,18,161,37,82,45,10,32,31,15,16,93,32,7,25,25,4,4,14,18
362208,132,40,89,44,12,33,36,24,30,80,39,14,25,24,8,4,13,20,132,40,89,44,12,33,36,24,30,80,39,14,25,24,8,4,13,20
362207,137,42,82,51,9,21,42,15,21,71,39,7,32,21,9,6,12,9,137,42,82,51,9,21,42,15,21,71,39,7,32,21,9,6,12,9
362206,158,43,92,46,15,36,41,19,23,82,42,6,36,33,7,3,15,21,158,43,92,46,15,36,41,19,23,82,42,6,36,33,7,3,15,21
362205,159,42,87,48,12,33,36,9,14,64,41,5,36,29,4,1,13,11,159,42,87,48,12,33,36,9,14,64,41,5,36,29,4,1,13,11
362209,136,35,79,44,10,29,34,17,22,77,34,5,29,19,10,3,16,21,136,35,79,44,10,29,34,17,22,77,34,5,29,19,10,3,16,21
362210,150,46,88,52,12,23,52,11,21,52,39,4,35,33,8,5,9,13,150,46,88,52,12,23,52,11,21,52,39,4,35,33,8,5,9,13
362211,156,36,89,40,10,37,27,13,18,72,48,19,29,17,11,2,18,17,156,36,89,40,10,37,27,13,18,72,48,19,29,17,11,2,18,17
362212,160,43,85,50,16,36,44,26,31,83,39,10,29,27,3,10,8,23,160,43,85,50,16,36,44,26,31,83,39,10,29,27,3,10,8,23
362213,144,36,83,43,13,34,38,21,30,70,47,8,39,22,10,7,12,19,144,36,83,43,13,34,38,21,30,70,47,8,39,22,10,7,12,19
372391,135,40,82,48,17,35,48,11,13,84,36,4,32,29,5,5,13,22,135,40,82,48,17,35,48,11,13,84,36,4,32,29,5,5,13,22
372392,150,44,86,51,12,29,41,20,23,87,40,13,27,27,9,5,17,26,150,44,86,51,12,29,41,20,23,87,40,13,27,27,9,5,17,26
372393,158,36,83,43,15,40,37,21,26,80,40,12,28,26,5,9,15,28,158,36,83,43,15,40,37,21,26,80,40,12,28,26,5,9,15,28
372394,148,49,94,52,17,45,37,17,20,85,41,5,36,29,8,3,6,16,148,49,94,52,17,45,37,17,20,85,41,5,36,29,8,3,6,16
372395,136,36,81,44,16,45,35,14,19,73,44,10,34,24,9,6,12,22,136,36,81,44,16,45,35,14,19,73,44,10,34,24,9,6,12,22
372397,134,38,81,46,11,28,39,12,16,75,45,9,36,24,2,8,15,14,134,38,81,46,11,28,39,12,16,75,45,9,36,24,2,8,15,14
372398,159,55,102,53,14,36,38,18,29,62,47,12,35,44,10,5,8,23,159,55,102,53,14,36,38,18,29,62,47,12,35,44,10,5,8,23
372399,143,42,95,44,8,31,25,24,31,77,40,11,29,24,10,7,16,32,143,42,95,44,8,31,25,24,31,77,40,11,29,24,10,7,16,32
372400,137,45,82,54,11,27,40,20,26,76,47,11,36,30,6,5,14,18,137,45,82,54,11,27,40,20,26,76,47,11,36,30,6,5,14,18
372401,138,41,88,46,12,34,35,19,26,73,40,11,29,23,8,2,10,15,138,41,88,46,12,34,35,19,26,73,40,11,29,23,8,2,10,15
372402,146,37,95,38,17,44,38,9,10,90,42,14,28,28,7,5,11,21,146,37,95,38,17,44,38,9,10,90,42,14,28,28,7,5,11,21
372404,156,34,85,40,9,34,26,14,21,66,31,13,18,21,10,2,19,15,156,34,85,40,9,34,26,14,21,66,31,13,18,21,10,2,19,15
372405,145,39,83,47,6,29,20,21,29,72,42,10,32,26,13,1,18,13,145,39,83,47,6,29,20,21,29,72,42,10,32,26,13,1,18,13
372407,140,36,81,44,7,21,33,24,26,92,43,11,32,21,7,5,18,24,140,36,81,44,7,21,33,24,26,92,43,11,32,21,7,5,18,24
372408,161,55,99,55,10,29,34,9,11,81,26,5,21,29,6,4,4,19,161,55,99,55,10,29,34,9,11,81,26,5,21,29,6,4,4,19
372409,136,37,81,45,11,37,29,15,16,93,36,7,29,21,2,7,11,16,136,37,81,45,11,37,29,15,16,93,36,7,29,21,2,7,11,16
372410,149,41,80,51,11,34,32,24,32,75,44,7,37,30,7,7,13,26,149,41,80,51,11,34,32,24,32,75,44,7,37,30,7,7,13,26
372411,150,50,92,54,12,28,42,17,21,81,55,10,45,38,8,6,10,19,150,50,92,54,12,28,42,17,21,81,55,10,45,38,8,6,10,19
372412,158,39,90,43,10,38,26,11,14,78,49,13,36,23,4,7,16,17,158,39,90,43,10,38,26,11,14,78,49,13,36,23,4,7,16,17
372413,141,36,77,46,21,43,48,28,33,84,43,8,35,26,3,1,8,21,141,36,77,46,21,43,48,28,33,84,43,8,35,26,3,1,8,21
362214,153,50,100,50,12,31,38,14,20,70,40,15,25,31,12,8,12,19,153,50,100,50,12,31,38,14,20,70,40,15,25,31,12,8,12,19
362215,132,57,95,60,15,31,48,23,28,82,39,12,27,28,8,4,15,23,132,57,95,60,15,31,48,23,28,82,39,12,27,28,8,4,15,23
362217,155,43,76,56,7,17,41,27,28,96,38,11,27,26,8,8,13,18,155,43,76,56,7,17,41,27,28,96,38,11,27,26,8,8,13,18
362218,145,49,86,57,11,29,37,22,27,81,52,9,43,35,6,5,13,15,145,49,86,57,11,29,37,22,27,81,52,9,43,35,6,5,13,15
372414,135,43,91,47,16,37,43,15,21,71,49,11,38,27,6,4,13,15,135,43,91,47,16,37,43,15,21,71,49,11,38,27,6,4,13,15
372415,153,44,81,54,10,29,34,26,30,86,41,11,30,27,9,7,12,21,153,44,81,54,10,29,34,26,30,86,41,11,30,27,9,7,12,21
372416,137,36,77,46,14,30,46,10,14,71,34,7,27,25,5,6,19,17,137,36,77,46,14,30,46,10,14,71,34,7,27,25,5,6,19,17
372417,143,50,91,54,18,39,46,13,16,81,31,5,26,33,10,6,15,24,143,50,91,54,18,39,46,13,16,81,31,5,26,33,10,6,15,24
372418,133,44,84,52,17,42,40,14,17,82,43,4,39,27,3,5,15,15,133,44,84,52,17,42,40,14,17,82,43,4,39,27,3,5,15,15
372424,158,35,91,38,11,38,28,21,23,91,44,10,34,26,8,6,14,24,158,35,91,38,11,38,28,21,23,91,44,10,34,26,8,6,14,24
372423,152,37,75,49,11,29,37,31,38,81,45,11,34,24,4,12,14,17,152,37,75,49,11,29,37,31,38,81,45,11,34,24,4,12,14,17
372421,149,43,89,48,10,26,38,16,24,66,48,10,38,28,10,8,13,21,149,43,89,48,10,26,38,16,24,66,48,10,38,28,10,8,13,21
372420,142,40,92,43,14,43,32,17,20,85,49,6,43,22,6,6,7,22,142,40,92,43,14,43,32,17,20,85,49,6,43,22,6,6,7,22
372422,150,41,87,47,7,30,23,28,37,75,48,13,35,23,10,2,10,28,150,41,87,47,7,30,23,28,37,75,48,13,35,23,10,2,10,28
372425,155,34,76,44,11,28,39,44,52,84,43,11,32,22,9,8,15,22,155,34,76,44,11,28,39,44,52,84,43,11,32,22,9,8,15,22
372426,156,47,92,51,17,39,43,10,15,66,37,14,23,31,9,6,14,21,156,47,92,51,17,39,43,10,15,66,37,14,23,31,9,6,14,21
372427,145,39,84,46,11,29,37,12,19,63,51,9,42,26,1,2,13,17,145,39,84,46,11,29,37,12,19,63,51,9,42,26,1,2,13,17
362219,153,43,85,50,11,28,39,16,22,72,48,13,35,23,5,3,18,28,153,43,85,50,11,28,39,16,22,72,48,13,35,23,5,3,18,28
362220,146,37,80,46,9,33,27,6,10,60,35,6,29,22,6,2,13,22,146,37,80,46,9,33,27,6,10,60,35,6,29,22,6,2,13,22
362222,151,39,81,48,10,29,34,12,18,66,46,6,40,21,7,2,19,14,151,39,81,48,10,29,34,12,18,66,46,6,40,21,7,2,19,14
362221,159,44,83,53,13,39,33,20,27,74,40,13,27,32,8,6,14,14,159,44,83,53,13,39,33,20,27,74,40,13,27,32,8,6,14,14
362226,149,36,82,43,12,33,36,27,29,93,44,10,34,25,6,9,18,18,149,36,82,43,12,33,36,27,29,93,44,10,34,25,6,9,18,18
362225,148,48,92,52,9,31,29,26,33,78,50,10,40,28,6,6,9,22,148,48,92,52,9,31,29,26,33,78,50,10,40,28,6,6,9,22
362223,142,40,82,48,12,29,41,13,15,86,49,6,43,25,9,9,14,21,142,40,82,48,12,29,41,13,15,86,49,6,43,25,9,9,14,21
362224,143,49,102,48,16,38,42,22,24,91,40,15,25,24,7,8,8,21,143,49,102,48,16,38,42,22,24,91,40,15,25,24,7,8,8,21
362227,141,40,81,49,19,41,46,19,24,79,41,7,34,35,7,2,24,21,141,40,81,49,19,41,46,19,24,79,41,7,34,35,7,2,24,21
362228,144,42,92,45,11,37,29,11,17,64,39,8,31,27,11,8,11,24,144,42,92,45,11,37,29,11,17,64,39,8,31,27,11,8,11,24
372428,152,43,98,43,16,43,37,21,26,80,38,13,25,29,3,3,4,27,152,43,98,43,16,43,37,21,26,80,38,13,25,29,3,3,4,27
372429,134,39,78,50,14,36,38,20,23,87,42,8,34,27,11,9,13,18,134,39,78,50,14,36,38,20,23,87,42,8,34,27,11,9,13,18
372430,161,43,88,48,10,38,26,12,12,100,41,8,33,33,5,6,20,17,161,43,88,48,10,38,26,12,12,100,41,8,33,33,5,6,20,17
372431,137,43,91,47,9,28,32,20,23,87,37,7,30,30,13,4,14,16,137,43,91,47,9,28,32,20,23,87,37,7,30,30,13,4,14,16
372432,160,38,87,43,15,43,34,14,17,82,52,14,38,23,8,6,24,13,160,38,87,43,15,43,34,14,17,82,52,14,38,23,8,6,24,13
372433,144,38,88,43,8,29,27,23,31,74,57,17,40,25,2,6,13,16,144,38,88,43,8,29,27,23,31,74,57,17,40,25,2,6,13,16
372434,148,35,89,39,14,42,33,24,32,75,52,18,34,19,13,11,17,20,148,35,89,39,14,42,33,24,32,75,52,18,34,19,13,11,17,20
372435,153,47,87,54,10,27,37,26,33,78,44,7,37,33,10,3,14,26,153,47,87,54,10,27,37,26,33,78,44,7,37,33,10,3,14,26
372436,133,42,95,44,13,47,27,16,20,80,58,18,40,24,9,3,12,19,133,42,95,44,13,47,27,16,20,80,58,18,40,24,9,3,12,19
372437,151,39,87,44,12,30,40,23,32,71,38,13,25,18,7,5,7,19,151,39,87,44,12,30,40,23,32,71,38,13,25,18,7,5,7,19
372438,146,34,88,38,10,37,27,19,27,70,35,11,24,24,4,4,13,18,146,34,88,38,10,37,27,19,27,70,35,11,24,24,4,4,13,18
372439,134,41,83,49,25,53,47,11,15,73,39,8,31,29,7,2,9,19,134,41,83,49,25,53,47,11,15,73,39,8,31,29,7,2,9,19
372440,137,45,97,46,10,31,32,5,6,83,49,12,37,29,2,5,14,18,137,45,97,46,10,31,32,5,6,83,49,12,37,29,2,5,14,18
372441,139,50,89,56,12,28,42,20,25,80,45,11,34,38,8,3,19,25,139,50,89,56,12,28,42,20,25,80,45,11,34,38,8,3,19,25
372444,154,47,93,50,22,46,47,22,26,84,48,15,33,33,11,2,5,17,154,47,93,50,22,46,47,22,26,84,48,15,33,33,11,2,5,17
372442,140,43,102,42,8,38,21,13,19,68,49,18,31,29,7,11,16,22,140,43,102,42,8,38,21,13,19,68,49,18,31,29,7,11,16,22
372443,143,42,88,47,8,33,24,18,24,75,42,10,32,26,10,6,20,24,143,42,88,47,8,33,24,18,24,75,42,10,32,26,10,6,20,24
372445,160,37,88,42,17,48,35,23,28,82,43,9,34,31,6,4,10,23,160,37,88,42,17,48,35,23,28,82,43,9,34,31,6,4,10,23
372446,144,35,85,41,6,20,30,28,34,82,49,16,33,18,6,9,13,23,144,35,85,41,6,20,30,28,34,82,49,16,33,18,6,9,13,23
362233,151,41,88,46,15,38,39,18,20,90,54,15,39,21,10,7,16,12,151,41,88,46,15,38,39,18,20,90,54,15,39,21,10,7,16,12
362229,133,47,90,52,21,49,42,9,12,75,52,11,41,36,6,9,16,18,133,47,90,52,21,49,42,9,12,75,52,11,41,36,6,9,16,18
362230,134,40,89,44,13,38,34,22,26,84,59,13,46,26,7,8,15,17,134,40,89,44,13,38,34,22,26,84,59,13,46,26,7,8,15,17
362231,137,50,93,53,13,36,36,15,17,88,55,12,43,27,8,12,16,20,137,50,93,53,13,36,36,15,17,88,55,12,43,27,8,12,16,20
362232,147,48,94,51,14,30,46,14,21,66,35,8,27,32,3,5,6,22,147,48,94,51,14,30,46,14,21,66,35,8,27,32,3,5,6,22
362234,149,33,78,42,14,33,42,26,32,81,51,10,41,18,3,9,19,17,149,33,78,42,14,33,42,26,32,81,51,10,41,18,3,9,19,17
362235,138,42,89,47,12,34,35,25,29,86,38,9,29,25,5,4,7,25,138,42,89,47,12,34,35,25,29,86,38,9,29,25,5,4,7,25
362236,157,41,91,45,15,44,34,27,42,64,46,12,34,25,8,7,10,23,157,41,91,45,15,44,34,27,42,64,46,12,34,25,8,7,10,23
372447,140,40,97,41,15,36,41,12,14,85,39,10,29,28,8,3,14,31,140,40,97,41,15,36,41,12,14,85,39,10,29,28,8,3,14,31
372448,153,51,84,60,17,27,63,20,24,83,44,9,35,34,5,6,18,22,153,51,84,60,17,27,63,20,24,83,44,9,35,34,5,6,18,22
372449,159,42,93,45,10,27,37,18,21,85,49,15,34,25,7,5,9,22,159,42,93,45,10,27,37,18,21,85,49,15,34,25,7,5,9,22
372450,146,43,87,49,13,39,33,6,8,75,51,12,39,26,9,10,15,15,146,43,87,49,13,39,33,6,8,75,51,12,39,26,9,10,15,15
372451,150,42,78,53,10,30,33,30,34,88,40,13,27,33,11,4,20,22,150,42,78,53,10,30,33,30,34,88,40,13,27,33,11,4,20,22
372452,139,48,95,50,19,43,44,19,26,73,41,13,28,37,4,2,3,18,139,48,95,50,19,43,44,19,26,73,41,13,28,37,4,2,3,18
372453,157,40,86,46,13,41,31,24,28,85,47,13,34,22,1,1,14,20,157,40,86,46,13,41,31,24,28,85,47,13,34,22,1,1,14,20
372454,137,38,89,42,7,32,21,12,12,100,35,14,21,25,12,2,17,15,137,38,89,42,7,32,21,12,12,100,35,14,21,25,12,2,17,15
372457,151,41,88,46,16,41,39,20,28,71,41,12,29,25,8,3,11,17,151,41,88,46,16,41,39,20,28,71,41,12,29,25,8,3,11,17
372456,147,48,86,55,8,21,38,38,45,84,48,10,38,25,4,1,14,28,147,48,86,55,8,21,38,38,45,84,48,10,38,25,4,1,14,28
372455,134,52,105,49,14,36,38,10,15,66,52,22,30,21,6,4,9,11,134,52,105,49,14,36,38,10,15,66,52,22,30,21,6,4,9,11
372459,149,39,89,43,13,35,37,10,13,76,42,10,32,29,13,7,11,16,149,39,89,43,13,35,37,10,13,76,42,10,32,29,13,7,11,16
372460,152,50,94,53,14,42,33,19,22,86,48,8,40,29,9,6,7,24,152,50,94,53,14,42,33,19,22,86,48,8,40,29,9,6,7,24
372461,158,48,89,53,18,41,43,21,23,91,47,11,36,34,4,7,21,22,158,48,89,53,18,41,43,21,23,91,47,11,36,34,4,7,21,22
372462,141,41,82,50,15,39,38,23,31,74,47,10,37,30,3,4,7,18,141,41,82,50,15,39,38,23,31,74,47,10,37,30,3,4,7,18
372463,153,46,89,51,12,31,38,26,33,78,44,10,34,35,6,8,15,23,153,46,89,51,12,31,38,26,33,78,44,10,34,35,6,8,15,23
372464,159,44,100,44,6,32,18,12,17,70,48,19,29,32,7,6,12,19,159,44,100,44,6,32,18,12,17,70,48,19,29,32,7,6,12,19
372465,138,34,92,37,12,39,30,14,21,66,42,13,29,27,9,5,12,13,138,34,92,37,12,39,30,14,21,66,42,13,29,27,9,5,12,13
372466,133,39,77,50,16,33,48,31,36,86,46,10,36,25,10,8,20,18,133,39,77,50,16,33,48,31,36,86,46,10,36,25,10,8,20,18
372467,150,42,85,49,10,31,32,27,29,93,42,10,32,26,8,6,12,15,150,42,85,49,10,31,32,27,29,93,42,10,32,26,8,6,12,15
372468,155,39,84,46,9,27,33,24,26,92,43,8,35,22,4,8,12,17,155,39,84,46,9,27,33,24,26,92,43,8,35,22,4,8,12,17
372469,144,44,90,48,13,39,33,12,14,85,40,5,35,31,5,6,11,21,144,44,90,48,13,39,33,12,14,85,40,5,35,31,5,6,11,21
372470,135,44,91,48,12,25,48,17,19,89,36,10,26,29,6,4,8,22,135,44,91,48,12,25,48,17,19,89,36,10,26,29,6,4,8,22
372471,134,46,91,50,14,34,41,23,31,74,57,14,43,31,4,7,11,21,134,46,91,50,14,34,41,23,31,74,57,14,43,31,4,7,11,21
372472,140,39,83,47,8,30,26,15,23,65,49,10,39,24,9,3,16,20,140,39,83,47,8,30,26,15,23,65,49,10,39,24,9,3,16,20
372473,136,48,88,54,17,40,42,11,15,73,41,12,29,32,6,8,13,21,136,48,88,54,17,40,42,11,15,73,41,12,29,32,6,8,13,21
372474,147,48,89,53,12,25,48,21,24,87,28,6,22,27,3,1,12,22,147,48,89,53,12,25,48,21,24,87,28,6,22,27,3,1,12,22
372475,148,53,89,59,14,33,42,12,15,80,44,8,36,33,5,6,16,19,148,53,89,59,14,33,42,12,15,80,44,8,36,33,5,6,16,19
372476,138,39,87,44,19,52,36,23,35,65,47,15,32,26,5,12,16,21,138,39,87,44,19,52,36,23,35,65,47,15,32,26,5,12,16,21
372477,155,36,83,43,9,26,34,35,43,81,44,12,32,24,10,5,17,21,155,36,83,43,9,26,34,35,43,81,44,12,32,24,10,5,17,21
372479,157,48,99,48,16,34,47,11,15,73,47,9,38,33,7,5,11,14,157,48,99,48,16,34,47,11,15,73,47,9,38,33,7,5,11,14
372480,145,40,89,44,8,27,29,19,27,70,48,9,39,24,11,7,12,17,145,40,89,44,8,27,29,19,27,70,48,9,39,24,11,7,12,17
383034,137,46,86,53,14,34,41,15,20,75,45,10,35,29,5,2,17,27,137,46,86,53,14,34,41,15,20,75,45,10,35,29,5,2,17,27
383035,140,41,91,45,11,35,31,9,9,100,42,8,34,30,9,6,17,17,140,41,91,45,11,35,31,9,9,100,42,8,34,30,9,6,17,17
383036,161,52,92,56,14,35,40,8,8,100,32,2,30,39,8,6,11,22,161,52,92,56,14,35,40,8,8,100,32,2,30,39,8,6,11,22
383037,159,37,86,43,14,37,37,15,17,88,46,8,38,29,3,8,14,18,159,37,86,43,14,37,37,15,17,88,46,8,38,29,3,8,14,18
383038,149,36,87,41,12,40,30,18,21,85,55,11,44,20,4,10,14,16,149,36,87,41,12,40,30,18,21,85,55,11,44,20,4,10,14,16
383039,132,42,94,44,12,35,34,17,18,94,49,11,38,25,5,4,13,23,132,42,94,44,12,35,34,17,18,94,49,11,38,25,5,4,13,23
383040,136,38,90,42,12,25,48,23,29,79,57,21,36,23,6,6,16,16,136,38,90,42,12,25,48,23,29,79,57,21,36,23,6,6,16,16
383041,142,40,83,48,15,33,45,15,22,68,53,10,43,28,6,5,21,16,142,40,83,48,15,33,45,15,22,68,53,10,43,28,6,5,21,16
383042,138,56,101,55,22,49,44,13,19,68,47,11,36,37,11,5,8,14,138,56,101,55,22,49,44,13,19,68,47,11,36,37,11,5,8,14
383044,144,40,87,46,12,27,44,19,25,76,51,13,38,21,7,9,11,14,144,40,87,46,12,27,44,19,25,76,51,13,38,21,7,9,11,14
383043,141,36,86,41,10,34,29,28,33,84,50,15,35,20,4,3,17,19,141,36,86,41,10,34,29,28,33,84,50,15,35,20,4,3,17,19
383045,154,42,87,48,11,30,36,30,37,81,48,14,34,24,6,8,10,14,154,42,87,48,11,30,36,30,37,81,48,14,34,24,6,8,10,14
383046,153,49,89,55,10,26,38,15,19,78,45,6,39,26,5,4,10,20,153,49,89,55,10,26,38,15,19,78,45,6,39,26,5,4,10,20
383047,135,44,79,55,13,25,52,18,20,90,31,7,24,30,7,4,15,15,135,44,79,55,13,25,52,18,20,90,31,7,24,30,7,4,15,15
383048,134,50,104,48,10,33,30,14,18,77,55,18,37,27,8,8,10,18,134,50,104,48,10,33,30,14,18,77,55,18,37,27,8,8,10,18
383541,133,48,91,52,19,47,40,18,21,85,34,8,26,24,8,5,7,19,133,48,91,52,19,47,40,18,21,85,34,8,26,24,8,5,7,19
383049,146,37,86,43,15,35,42,14,19,73,28,8,20,24,7,4,9,23,146,37,86,43,15,35,42,14,19,73,28,8,20,24,7,4,9,23
383050,147,37,86,43,15,42,35,10,15,66,37,7,30,23,5,5,18,23,147,37,86,43,15,42,35,10,15,66,37,7,30,23,5,5,18,23
383052,158,39,83,47,17,42,40,17,20,85,44,10,34,35,4,9,12,20,158,39,83,47,17,42,40,17,20,85,44,10,34,35,4,9,12,20
383542,155,40,83,48,11,32,34,15,23,65,40,8,32,26,8,5,11,19,155,40,83,48,11,32,34,15,23,65,40,8,32,26,8,5,11,19
383053,139,38,90,42,10,28,35,20,27,74,47,12,35,22,4,5,10,24,139,38,90,42,10,28,35,20,27,74,47,12,35,22,4,5,10,24
383054,156,39,105,37,18,53,34,16,18,88,48,18,30,20,9,1,15,24,156,39,105,37,18,53,34,16,18,88,48,18,30,20,9,1,15,24
383055,160,38,84,45,9,31,29,18,24,75,40,8,32,23,10,10,13,17,160,38,84,45,9,31,29,18,24,75,40,8,32,23,10,10,13,17
372481,153,39,84,46,7,26,26,19,25,76,43,12,31,22,7,8,14,22,153,39,84,46,7,26,26,19,25,76,43,12,31,22,7,8,14,22
372482,154,52,95,54,20,46,43,22,25,88,47,9,38,37,14,6,14,27,154,52,95,54,20,46,43,22,25,88,47,9,38,37,14,6,14,27
372483,140,45,81,55,10,29,34,23,30,76,30,6,24,26,11,4,15,18,140,45,81,55,10,29,34,23,30,76,30,6,24,26,11,4,15,18
372484,135,40,84,47,17,41,41,17,22,77,31,6,25,31,3,2,11,22,135,40,84,47,17,41,41,17,22,77,31,6,25,31,3,2,11,22
372485,151,52,86,60,17,29,58,15,23,65,42,14,28,36,5,3,15,22,151,52,86,60,17,29,58,15,23,65,42,14,28,36,5,3,15,22
372486,132,44,96,45,17,44,38,17,18,94,35,13,22,25,9,2,10,21,132,44,96,45,17,44,38,17,18,94,35,13,22,25,9,2,10,21
372491,152,50,96,52,18,38,47,16,17,94,39,7,32,35,9,7,12,17,152,50,96,52,18,38,47,16,17,94,39,7,32,35,9,7,12,17
372490,150,40,82,48,10,27,37,31,40,77,47,10,37,27,7,7,14,20,150,40,82,48,10,27,37,31,40,77,47,10,37,27,7,7,14,20
372488,146,41,89,46,18,44,40,13,16,81,38,10,28,26,9,5,18,19,146,41,89,46,18,44,40,13,16,81,38,10,28,26,9,5,18,19
372487,142,32,93,34,12,39,30,17,20,85,60,15,45,20,7,2,16,18,142,32,93,34,12,39,30,17,20,85,60,15,45,20,7,2,16,18
372492,157,48,94,51,25,45,55,10,14,71,43,10,33,38,4,3,13,24,157,48,94,51,25,45,55,10,14,71,43,10,33,38,4,3,13,24
372493,144,49,89,55,13,34,38,21,22,95,35,9,26,33,7,9,9,20,144,49,89,55,13,34,38,21,22,95,35,9,26,33,7,9,9,20
372494,133,38,84,45,18,44,40,26,26,100,45,12,33,23,9,9,15,13,133,38,84,45,18,44,40,26,26,100,45,12,33,23,9,9,15,13
372495,138,44,89,49,21,43,48,18,21,85,36,12,24,28,7,5,10,17,138,44,89,49,21,43,48,18,21,85,36,12,24,28,7,5,10,17
372496,136,36,86,41,13,40,32,21,23,91,41,11,30,26,6,9,14,22,136,36,86,41,13,40,32,21,23,91,41,11,30,26,6,9,14,22
372497,155,38,84,45,14,39,35,29,34,85,41,7,34,27,8,7,15,22,155,38,84,45,14,39,35,29,34,85,41,7,34,27,8,7,15,22
372498,144,44,84,52,11,29,37,20,21,95,49,6,43,21,7,2,17,17,144,44,84,52,11,29,37,20,21,95,49,6,43,21,7,2,17,17
372500,161,42,82,51,19,44,43,19,24,79,33,3,30,28,7,6,15,16,161,42,82,51,19,44,43,19,24,79,33,3,30,28,7,6,15,16
372499,140,39,88,44,10,33,30,23,30,76,35,6,29,24,6,3,10,22,140,39,88,44,10,33,30,23,30,76,35,6,29,24,6,3,10,22
372501,147,41,86,47,15,30,50,18,19,94,47,17,30,29,10,3,23,12,147,41,86,47,15,30,50,18,19,94,47,17,30,29,10,3,23,12
372502,159,50,87,57,18,34,52,17,24,70,47,9,38,39,3,9,15,18,159,50,87,57,18,34,52,17,24,70,47,9,38,39,3,9,15,18
372503,158,45,96,46,16,37,43,13,18,72,46,10,36,28,8,6,17,16,158,45,96,46,16,37,43,13,18,72,46,10,36,28,8,6,17,16
372504,142,39,86,45,12,32,37,27,37,73,58,15,43,23,6,3,19,28,142,39,86,45,12,32,37,27,37,73,58,15,43,23,6,3,19,28
372505,148,48,89,53,7,27,25,37,48,77,43,12,31,27,8,8,16,24,148,48,89,53,7,27,25,37,48,77,43,12,31,27,8,8,16,24
372506,155,40,84,47,9,28,32,23,27,85,49,14,35,28,5,4,12,20,155,40,84,47,9,28,32,23,27,85,49,14,35,28,5,4,12,20
372507,160,43,98,43,16,42,38,15,21,71,53,15,38,31,5,4,16,27,160,43,98,43,16,42,38,15,21,71,53,15,38,31,5,4,16,27
372508,133,43,85,50,13,36,36,17,20,85,44,13,31,22,7,8,13,15,133,43,85,50,13,36,36,17,20,85,44,13,31,22,7,8,13,15
372509,147,37,80,46,15,34,44,27,35,77,42,8,34,26,2,1,10,20,147,37,80,46,15,34,44,27,35,77,42,8,34,26,2,1,10,20
372510,138,39,83,47,7,32,21,16,18,88,34,4,30,21,6,2,15,19,138,39,83,47,7,32,21,16,18,88,34,4,30,21,6,2,15,19
372511,139,47,99,47,12,36,33,18,21,85,48,12,36,31,13,6,8,15,139,47,99,47,12,36,33,18,21,85,48,12,36,31,13,6,8,15
372512,156,43,103,41,16,45,35,12,18,66,49,21,28,30,9,4,11,12,156,43,103,41,16,45,35,12,18,66,49,21,28,30,9,4,11,12
372513,157,47,95,49,18,45,40,16,21,76,47,11,36,32,6,4,17,22,157,47,95,49,18,45,40,16,21,76,47,11,36,32,6,4,17,22
372514,144,41,81,50,13,32,40,26,30,86,40,10,30,27,6,9,13,20,144,41,81,50,13,32,40,26,30,86,40,10,30,27,6,9,13,20
372515,135,41,92,44,9,31,29,16,21,76,39,8,31,18,7,4,8,24,135,41,92,44,9,31,29,16,21,76,39,8,31,18,7,4,8,24
372516,154,41,98,41,14,37,37,28,31,90,54,16,38,24,17,8,12,23,154,41,98,41,14,37,37,28,31,90,54,16,38,24,17,8,12,23
372517,161,52,92,56,13,27,48,20,26,76,47,8,39,36,7,8,19,18,161,52,92,56,13,27,48,20,26,76,47,8,39,36,7,8,19,18
372520,159,40,77,51,10,31,32,14,25,56,32,3,29,30,8,6,14,19,159,40,77,51,10,31,32,14,25,56,32,3,29,30,8,6,14,19
372519,158,47,95,49,18,42,42,17,19,89,45,9,36,35,5,5,8,19,158,47,95,49,18,42,42,17,19,89,45,9,36,35,5,5,8,19
372518,133,48,92,52,18,42,42,14,20,70,34,9,25,31,14,7,11,22,133,48,92,52,18,42,42,14,20,70,34,9,25,31,14,7,11,22
372521,146,37,92,40,11,40,27,11,15,73,48,13,35,19,4,8,17,24,146,37,92,40,11,40,27,11,15,73,48,13,35,19,4,8,17,24
372522,155,47,90,52,11,28,39,17,21,81,33,10,23,30,4,3,11,17,155,47,90,52,11,28,39,17,21,81,33,10,23,30,4,3,11,17
372523,148,50,88,56,19,42,45,27,32,84,49,8,41,24,5,8,15,24,148,50,88,56,19,42,45,27,32,84,49,8,41,24,5,8,15,24
372524,135,33,91,36,7,35,20,9,11,81,36,8,28,15,3,4,13,14,135,33,91,36,7,35,20,9,11,81,36,8,28,15,3,4,13,14
372525,137,49,101,48,16,42,38,13,15,86,49,18,31,32,8,3,11,22,137,49,101,48,16,42,38,13,15,86,49,18,31,32,8,3,11,22
372526,147,43,83,51,13,35,37,19,25,76,31,8,23,26,7,2,10,19,147,43,83,51,13,35,37,19,25,76,31,8,23,26,7,2,10,19
372527,149,48,86,55,18,30,60,13,16,81,36,8,28,33,10,4,15,16,149,48,86,55,18,30,60,13,16,81,36,8,28,33,10,4,15,16
372528,141,44,91,48,17,32,53,19,20,95,42,13,29,29,7,5,14,15,141,44,91,48,17,32,53,19,20,95,42,13,29,29,7,5,14,15
372529,139,42,94,44,12,32,37,21,24,87,47,17,30,30,5,0,9,22,139,42,94,44,12,32,37,21,24,87,47,17,30,30,5,0,9,22
372530,156,47,94,50,7,32,21,19,22,86,44,10,34,17,8,2,11,21,156,47,94,50,7,32,21,19,22,86,44,10,34,17,8,2,11,21
372531,157,46,85,54,22,45,48,11,15,73,45,8,37,36,6,2,14,17,157,46,85,54,22,45,48,11,15,73,45,8,37,36,6,2,14,17
372532,144,50,88,56,16,33,48,28,34,82,42,8,34,36,8,6,9,21,144,50,88,56,16,33,48,28,34,82,42,8,34,36,8,6,9,21
372533,133,45,95,47,17,36,47,7,8,87,55,10,45,18,4,10,14,19,133,45,95,47,17,36,47,7,8,87,55,10,45,18,4,10,14,19
372534,158,40,94,42,15,42,35,15,21,71,39,9,30,29,6,6,13,15,158,40,94,42,15,42,35,15,21,71,39,9,30,29,6,6,13,15
372535,148,45,90,50,13,36,36,25,32,78,46,16,30,25,4,1,17,23,148,45,90,50,13,36,36,25,32,78,46,16,30,25,4,1,17,23
372536,155,41,90,45,7,31,22,23,30,76,54,13,41,29,8,6,17,16,155,41,90,45,7,31,22,23,30,76,54,13,41,29,8,6,17,16
372537,156,40,85,47,13,35,37,21,23,91,37,9,28,23,10,4,14,20,156,40,85,47,13,35,37,21,23,91,37,9,28,23,10,4,14,20
372539,143,49,95,51,12,33,36,17,21,81,34,11,23,38,6,7,11,21,143,49,95,51,12,33,36,17,21,81,34,11,23,38,6,7,11,21
372540,154,38,88,43,11,32,34,17,19,89,44,9,35,23,8,8,12,17,154,38,88,43,11,32,34,17,19,89,44,9,35,23,8,8,12,17
372543,147,41,87,47,11,30,36,15,18,83,40,9,31,27,10,4,15,18,147,41,87,47,11,30,36,15,18,83,40,9,31,27,10,4,15,18
372541,159,44,86,51,8,29,27,18,22,81,51,15,36,30,4,4,17,16,159,44,86,51,8,29,27,18,22,81,51,15,36,30,4,4,17,16
372542,132,46,85,54,16,36,44,22,27,81,40,11,29,25,6,10,17,24,132,46,85,54,16,36,44,22,27,81,40,11,29,25,6,10,17,24
372544,152,42,92,45,11,36,30,21,23,91,53,10,43,31,11,10,12,18,152,42,92,45,11,36,30,21,23,91,53,10,43,31,11,10,12,18
372545,139,49,87,56,14,26,53,18,22,81,46,9,37,29,7,4,9,19,139,49,87,56,14,26,53,18,22,81,46,9,37,29,7,4,9,19
372546,160,45,91,49,14,34,41,21,24,87,51,12,39,30,6,8,14,20,160,45,91,49,14,34,41,21,24,87,51,12,39,30,6,8,14,20
372547,157,53,100,53,17,43,39,20,26,76,42,9,33,35,8,5,7,24,157,53,100,53,17,43,39,20,26,76,42,9,33,35,8,5,7,24
372548,145,42,99,42,13,41,31,12,13,92,41,9,32,29,9,3,10,17,145,42,99,42,13,41,31,12,13,92,41,9,32,29,9,3,10,17
372549,150,40,85,47,11,25,44,22,24,91,39,11,28,23,4,3,11,23,150,40,85,47,11,25,44,22,24,91,39,11,28,23,4,3,11,23
372550,148,50,106,47,18,49,36,14,18,77,47,11,36,34,11,7,6,15,148,50,106,47,18,49,36,14,18,77,47,11,36,34,11,7,6,15
372552,156,39,87,44,14,28,50,17,19,89,42,10,32,23,8,4,15,18,156,39,87,44,14,28,50,17,19,89,42,10,32,23,8,4,15,18
372553,137,45,96,46,23,51,45,11,16,68,44,14,30,34,8,3,12,23,137,45,96,46,23,51,45,11,16,68,44,14,30,34,8,3,12,23
372554,143,49,80,61,18,39,46,28,30,93,38,8,30,37,6,8,13,20,143,49,80,61,18,39,46,28,30,93,38,8,30,37,6,8,13,20
372555,153,41,89,46,9,36,25,15,19,78,49,15,34,29,8,5,12,24,153,41,89,46,9,36,25,15,19,78,49,15,34,29,8,5,12,24
372556,154,45,84,53,8,22,36,29,32,90,36,7,29,20,9,3,12,25,154,45,84,53,8,22,36,29,32,90,36,7,29,20,9,3,12,25
372557,134,37,101,36,15,47,31,13,17,76,49,17,32,25,6,9,11,20,134,37,101,36,15,47,31,13,17,76,49,17,32,25,6,9,11,20
372558,159,43,90,47,9,27,33,9,13,69,41,10,31,26,3,5,11,12,159,43,90,47,9,27,33,9,13,69,41,10,31,26,3,5,11,12
372559,142,44,89,49,16,34,47,23,23,100,37,8,29,25,4,6,9,23,142,44,89,49,16,34,47,23,23,100,37,8,29,25,4,6,9,23
372560,136,48,88,54,18,34,52,10,11,90,48,7,41,25,7,6,16,15,136,48,88,54,18,34,52,10,11,90,48,7,41,25,7,6,16,15
372561,138,39,91,42,14,43,32,19,27,70,36,13,23,23,8,3,8,19,138,39,91,42,14,43,32,19,27,70,36,13,23,23,8,3,8,19
372562,157,43,91,47,21,44,47,12,23,52,37,12,25,29,4,8,7,15,157,43,91,47,21,44,47,12,23,52,37,12,25,29,4,8,7,15
372563,140,43,86,50,9,31,29,16,19,84,41,12,29,24,6,9,21,19,140,43,86,50,9,31,29,16,19,84,41,12,29,24,6,9,21,19
372564,137,41,87,47,17,44,38,5,8,62,35,6,29,34,4,3,11,13,137,41,87,47,17,44,38,5,8,62,35,6,29,34,4,3,11,13
372565,136,49,90,54,7,28,25,9,11,81,36,5,31,24,11,5,11,18,136,49,90,54,7,28,25,9,11,81,36,5,31,24,11,5,11,18
372566,146,43,84,51,16,35,45,14,21,66,41,8,33,27,8,7,18,14,146,43,84,51,16,35,45,14,21,66,41,8,33,27,8,7,18,14
372567,148,38,90,42,11,37,29,31,35,88,51,10,41,26,3,6,13,22,148,38,90,42,11,37,29,31,35,88,51,10,41,26,3,6,13,22
372568,152,51,87,58,16,34,47,16,18,88,38,6,32,35,9,5,11,11,152,51,87,58,16,34,47,16,18,88,38,6,32,35,9,5,11,11
372569,149,42,87,48,14,36,38,20,25,80,40,9,31,32,13,7,14,19,149,42,87,48,14,36,38,20,25,80,40,9,31,32,13,7,14,19
372570,156,43,95,45,14,30,46,17,23,73,51,20,31,24,7,6,15,27,156,43,95,45,14,30,46,17,23,73,51,20,31,24,7,6,15,27
372571,154,44,83,53,14,31,45,19,21,90,38,3,35,34,6,6,14,21,154,44,83,53,14,31,45,19,21,90,38,3,35,34,6,6,14,21
372572,134,43,89,48,13,33,39,18,26,69,45,14,31,32,4,7,11,23,134,43,89,48,13,33,39,18,26,69,45,14,31,32,4,7,11,23
372574,147,40,86,46,17,39,43,25,30,83,48,12,36,21,7,2,17,18,147,40,86,46,17,39,43,25,30,83,48,12,36,21,7,2,17,18
372573,142,46,95,48,11,38,28,19,23,82,63,12,51,21,7,3,17,22,142,46,95,48,11,38,28,19,23,82,63,12,51,21,7,3,17,22
372575,141,47,97,48,18,45,40,17,20,85,57,14,43,33,5,2,12,17,141,47,97,48,18,45,40,17,20,85,57,14,43,33,5,2,12,17
372576,157,44,83,53,12,38,31,20,26,76,37,7,30,32,7,7,14,24,157,44,83,53,12,38,31,20,26,76,37,7,30,32,7,7,14,24
372577,151,41,93,44,9,29,31,20,21,95,41,11,30,17,5,2,11,22,151,41,93,44,9,29,31,20,21,95,41,11,30,17,5,2,11,22
372578,144,41,89,46,11,34,32,15,15,100,34,9,25,25,4,4,10,24,144,41,89,46,11,34,32,15,15,100,34,9,25,25,4,4,10,24
372579,135,34,88,38,8,28,28,19,23,82,47,13,34,23,8,11,18,15,135,34,88,38,8,28,28,19,23,82,47,13,34,23,8,11,18,15
372580,143,43,82,52,15,34,44,9,13,69,33,7,26,27,7,6,15,30,143,43,82,52,15,34,44,9,13,69,33,7,26,27,7,6,15,30
372581,150,38,82,46,8,31,25,20,29,69,46,13,33,21,9,7,16,22,150,38,82,46,8,31,25,20,29,69,46,13,33,21,9,7,16,22
372583,134,45,86,52,10,24,41,26,32,81,38,7,31,32,10,3,12,22,134,45,86,52,10,24,41,26,32,81,38,7,31,32,10,3,12,22
372584,159,45,94,47,13,32,40,16,19,84,39,12,27,35,7,5,11,17,159,45,94,47,13,32,40,16,19,84,39,12,27,35,7,5,11,17
372582,132,45,96,46,13,43,30,16,20,80,41,13,28,28,8,5,11,22,132,45,96,46,13,43,30,16,20,80,41,13,28,28,8,5,11,22
372585,136,35,80,43,8,35,22,17,19,89,37,5,32,23,6,5,12,22,136,35,80,43,8,35,22,17,19,89,37,5,32,23,6,5,12,22
372586,152,46,95,48,13,41,31,15,19,78,42,11,31,24,6,7,9,17,152,46,95,48,13,41,31,15,19,78,42,11,31,24,6,7,9,17
372587,138,52,100,52,23,45,51,17,21,81,52,11,41,26,7,6,12,18,138,52,100,52,23,45,51,17,21,81,52,11,41,26,7,6,12,18
372588,141,48,83,57,10,33,30,20,24,83,49,13,36,38,8,2,16,14,141,48,83,57,10,33,30,20,24,83,49,13,36,38,8,2,16,14
372589,157,37,85,43,8,33,24,16,21,76,40,8,32,23,10,2,11,20,157,37,85,43,8,33,24,16,21,76,40,8,32,23,10,2,11,20
372590,151,50,92,54,8,26,30,21,26,80,41,7,34,27,7,4,12,18,151,50,92,54,8,26,30,21,26,80,41,7,34,27,7,4,12,18
372591,139,40,82,48,14,34,41,26,32,81,43,10,33,25,6,4,14,17,139,40,82,48,14,34,41,26,32,81,43,10,33,25,6,4,14,17
372592,145,43,90,47,13,32,40,16,21,76,43,13,30,24,4,1,12,19,145,43,90,47,13,32,40,16,21,76,43,13,30,24,4,1,12,19
372593,147,40,84,47,12,32,37,27,35,77,56,13,43,27,5,7,14,17,147,40,84,47,12,32,37,27,35,77,56,13,43,27,5,7,14,17
372594,155,40,90,44,14,41,34,20,25,80,47,14,33,28,5,2,16,21,155,40,90,44,14,41,34,20,25,80,47,14,33,28,5,2,16,21
372596,161,43,87,49,16,42,38,17,21,81,47,10,37,27,10,8,20,21,161,43,87,49,16,42,38,17,21,81,47,10,37,27,10,8,20,21
372595,140,40,90,44,9,25,36,23,32,71,52,16,36,20,6,4,14,27,140,40,90,44,9,25,36,23,32,71,52,16,36,20,6,4,14,27
372597,152,49,81,60,18,39,46,13,16,81,29,3,26,35,9,7,15,24,152,49,81,60,18,39,46,13,16,81,29,3,26,35,9,7,15,24
372598,158,44,98,44,16,35,45,14,21,66,43,13,30,36,8,8,9,18,158,44,98,44,16,35,45,14,21,66,43,13,30,36,8,8,9,18
372599,136,42,92,45,7,25,28,27,31,87,48,18,30,23,10,2,10,17,136,42,92,45,7,25,28,27,31,87,48,18,30,23,10,2,10,17
372601,142,47,97,48,5,24,20,18,22,81,44,15,29,19,15,2,11,16,142,47,97,48,5,24,20,18,22,81,44,15,29,19,15,2,11,16
372602,156,49,98,50,16,40,40,16,20,80,46,16,30,28,5,5,10,17,156,49,98,50,16,40,40,16,20,80,46,16,30,28,5,5,10,17
372603,144,40,85,47,14,34,41,19,25,76,45,11,34,24,7,3,13,14,144,40,85,47,14,34,41,19,25,76,45,11,34,24,7,3,13,14
372605,161,42,90,46,8,33,24,10,15,66,34,10,24,25,11,3,16,17,161,42,90,46,8,33,24,10,15,66,34,10,24,25,11,3,16,17
372604,153,31,79,39,9,33,27,21,24,87,43,9,34,17,5,10,16,18,153,31,79,39,9,33,27,21,24,87,43,9,34,17,5,10,16,18
372606,134,45,101,44,7,32,21,25,29,86,47,17,30,29,7,2,9,17,134,45,101,44,7,32,21,25,29,86,47,17,30,29,7,2,9,17
372607,142,40,96,41,17,41,41,16,22,72,33,9,24,20,11,3,10,21,142,40,96,41,17,41,41,16,22,72,33,9,24,20,11,3,10,21
372608,152,49,90,54,14,32,43,17,22,77,27,3,24,20,6,10,4,21,152,49,90,54,14,32,43,17,22,77,27,3,24,20,6,10,4,21
372609,138,39,88,44,10,37,27,22,26,84,37,7,30,21,12,7,10,21,138,39,88,44,10,37,27,22,26,84,37,7,30,21,12,7,10,21
372613,150,45,82,54,10,27,37,12,15,80,35,6,29,27,10,7,14,19,150,45,82,54,10,27,37,12,15,80,35,6,29,27,10,7,14,19
372611,136,40,97,41,7,27,25,17,22,77,46,13,33,19,7,4,7,20,136,40,97,41,7,27,25,17,22,77,46,13,33,19,7,4,7,20
372612,149,38,74,51,17,33,51,25,34,73,38,6,32,23,9,10,22,21,149,38,74,51,17,33,51,25,34,73,38,6,32,23,9,10,22,21
372614,139,55,96,57,20,41,48,12,14,85,53,12,41,43,6,7,11,19,139,55,96,57,20,41,48,12,14,85,53,12,41,43,6,7,11,19
372615,141,37,88,42,8,33,24,20,25,80,43,12,31,27,4,7,13,19,141,37,88,42,8,33,24,20,25,80,43,12,31,27,4,7,13,19
372616,156,35,101,34,11,36,30,24,32,75,57,22,35,16,6,4,13,22,156,35,101,34,11,36,30,24,32,75,57,22,35,16,6,4,13,22
372617,145,52,97,53,15,30,50,14,14,100,42,5,37,41,11,7,11,21,145,52,97,53,15,30,50,14,14,100,42,5,37,41,11,7,11,21
372618,153,40,89,44,7,33,21,30,40,75,49,14,35,24,10,6,15,20,153,40,89,44,7,33,21,30,40,75,49,14,35,24,10,6,15,20
372619,161,46,91,50,15,38,39,3,7,42,43,8,35,28,5,5,7,19,161,46,91,50,15,38,39,3,7,42,43,8,35,28,5,5,7,19
372620,132,37,94,39,15,43,34,21,25,84,51,18,33,29,9,4,15,16,132,37,94,39,15,43,34,21,25,84,51,18,33,29,9,4,15,16
372621,133,43,88,48,17,39,43,17,20,85,52,13,39,29,3,6,16,17,133,43,88,48,17,39,43,17,20,85,52,13,39,29,3,6,16,17
372622,137,49,103,47,6,43,14,7,9,77,37,7,30,28,11,7,8,20,137,49,103,47,6,43,14,7,9,77,37,7,30,28,11,7,8,20
372623,142,49,91,53,14,30,46,15,21,71,42,14,28,30,8,6,16,24,142,49,91,53,14,30,46,15,21,71,42,14,28,30,8,6,16,24
372624,155,46,74,62,18,30,60,23,24,95,39,6,33,34,3,11,14,14,155,46,74,62,18,30,60,23,24,95,39,6,33,34,3,11,14,14
372625,139,36,85,42,10,37,27,11,15,73,36,5,31,30,6,5,16,17,139,36,85,42,10,37,27,11,15,73,36,5,31,30,6,5,16,17
372626,156,48,95,50,16,27,59,22,27,81,43,16,27,28,8,6,14,19,156,48,95,50,16,27,59,22,27,81,43,16,27,28,8,6,14,19
372627,144,43,87,49,11,39,28,20,25,80,54,11,43,28,3,6,17,19,144,43,87,49,11,39,28,20,25,80,54,11,43,28,3,6,17,19
372628,160,43,93,46,11,41,26,20,28,71,43,9,34,29,8,6,10,25,160,43,93,46,11,41,26,20,28,71,43,9,34,29,8,6,10,25
372629,140,41,82,50,12,28,42,35,40,87,41,6,35,29,4,4,11,22,140,41,82,50,12,28,42,35,40,87,41,6,35,29,4,4,11,22
372630,143,50,85,58,23,43,53,17,21,81,34,7,27,40,6,7,16,18,143,50,85,58,23,43,53,17,21,81,34,7,27,40,6,7,16,18
372631,136,40,79,50,7,25,28,18,30,60,53,12,41,21,5,5,17,15,136,40,79,50,7,25,28,18,30,60,53,12,41,21,5,5,17,15
372632,149,38,76,50,12,34,35,20,24,83,45,7,38,24,8,8,19,26,149,38,76,50,12,34,35,20,24,83,45,7,38,24,8,8,19,26
372633,141,47,103,45,19,48,39,9,13,69,47,16,31,32,8,3,11,21,141,47,103,45,19,48,39,9,13,69,47,16,31,32,8,3,11,21
372634,161,46,98,46,17,53,32,17,21,81,42,6,36,35,5,9,9,21,161,46,98,46,17,53,32,17,21,81,42,6,36,35,5,9,9,21
372635,150,45,87,51,17,34,50,22,27,81,47,12,35,33,9,6,13,22,150,45,87,51,17,34,50,22,27,81,47,12,35,33,9,6,13,22
372636,152,45,83,54,18,33,54,16,20,80,46,5,41,31,1,6,15,24,152,45,83,54,18,33,54,16,20,80,46,5,41,31,1,6,15,24
372637,158,40,94,42,12,45,26,9,12,75,39,9,30,28,6,1,16,17,158,40,94,42,12,45,26,9,12,75,39,9,30,28,6,1,16,17
372639,155,44,88,50,8,27,29,16,19,84,35,6,29,21,11,4,6,17,155,44,88,50,8,27,29,16,19,84,35,6,29,21,11,4,6,17
372638,146,30,82,36,12,40,30,20,28,71,34,1,33,20,4,1,8,14,146,30,82,36,12,40,30,20,28,71,34,1,33,20,4,1,8,14
372640,151,39,89,43,12,34,35,22,28,78,49,16,33,23,7,4,15,24,151,39,89,43,12,34,35,22,28,78,49,16,33,23,7,4,15,24
372641,159,42,87,48,11,30,36,29,40,72,47,10,37,25,5,4,11,22,159,42,87,48,11,30,36,29,40,72,47,10,37,25,5,4,11,22
372642,148,41,93,44,10,40,25,21,26,80,46,8,38,27,4,8,11,26,148,41,93,44,10,40,25,21,26,80,46,8,38,27,4,8,11,26
372643,142,51,91,56,15,35,42,19,24,79,39,6,33,34,11,1,9,19,142,51,91,56,15,35,42,19,24,79,39,6,33,34,11,1,9,19
372644,139,41,83,49,15,38,39,14,18,77,44,4,40,27,9,9,10,15,139,41,83,49,15,38,39,14,18,77,44,4,40,27,9,9,10,15
372645,155,38,80,47,11,29,37,22,33,66,47,9,38,24,10,5,16,20,155,38,80,47,11,29,37,22,33,66,47,9,38,24,10,5,16,20
372646,160,49,96,51,12,44,27,17,18,94,53,7,46,37,9,6,12,15,160,49,96,51,12,44,27,17,18,94,53,7,46,37,9,6,12,15
372647,144,47,80,58,14,29,48,13,14,92,37,6,31,25,10,3,15,20,144,47,80,58,14,29,48,13,14,92,37,6,31,25,10,3,15,20
372648,154,38,80,47,12,30,40,22,30,73,43,6,37,28,9,6,17,22,154,38,80,47,12,30,40,22,30,73,43,6,37,28,9,6,17,22
372651,152,48,91,52,18,40,45,13,17,76,38,10,28,34,7,10,10,22,152,48,91,52,18,40,45,13,17,76,38,10,28,34,7,10,10,22
372649,146,37,80,46,12,38,31,20,25,80,46,8,38,24,5,8,15,23,146,37,80,46,12,38,31,20,25,80,46,8,38,24,5,8,15,23
372650,150,41,88,46,16,39,41,14,18,77,53,17,36,23,10,9,17,12,150,41,88,46,16,39,41,14,18,77,53,17,36,23,10,9,17,12
372652,157,40,92,43,14,36,38,10,17,58,48,15,33,23,8,2,21,23,157,40,92,43,14,36,38,10,17,58,48,15,33,23,8,2,21,23
372653,141,42,78,53,13,35,37,24,37,64,36,9,27,23,9,6,12,19,141,42,78,53,13,35,37,24,37,64,36,9,27,23,9,6,12,19
372654,137,54,101,53,20,42,47,12,16,75,62,18,44,37,5,8,11,13,137,54,101,53,20,42,47,12,16,75,62,18,44,37,5,8,11,13
372655,143,50,90,55,14,35,40,28,34,82,44,7,37,34,7,5,11,27,143,50,90,55,14,35,40,28,34,82,44,7,37,34,7,5,11,27
372656,132,48,95,50,14,39,35,31,33,93,49,15,34,30,8,5,11,21,132,48,95,50,14,39,35,31,33,93,49,15,34,30,8,5,11,21
372659,146,40,94,42,15,42,35,16,19,84,43,9,34,25,7,5,10,19,146,40,94,42,15,42,35,16,19,84,43,9,34,25,7,5,10,19
372660,149,37,82,45,10,31,32,22,27,81,28,8,20,26,7,6,11,13,149,37,82,45,10,31,32,22,27,81,28,8,20,26,7,6,11,13
372658,142,37,76,48,19,39,48,19,27,70,48,5,43,27,5,4,16,19,142,37,76,48,19,39,48,19,27,70,48,5,43,27,5,4,16,19
372661,138,42,84,50,13,30,43,29,41,70,43,7,36,25,12,7,11,18,138,42,84,50,13,30,43,29,41,70,43,7,36,25,12,7,11,18
372657,151,46,89,51,15,38,39,9,11,81,52,13,39,29,6,7,15,17,151,46,89,51,15,38,39,9,11,81,52,13,39,29,6,7,15,17
372662,155,42,79,53,15,35,42,23,26,88,32,10,22,23,9,2,16,23,155,42,79,53,15,35,42,23,26,88,32,10,22,23,9,2,16,23
372664,145,35,83,42,4,30,13,22,24,91,50,9,41,29,3,6,21,14,145,35,83,42,4,30,13,22,24,91,50,9,41,29,3,6,21,14
372666,158,46,95,48,14,40,35,15,17,88,42,10,32,31,10,8,11,16,158,46,95,48,14,40,35,15,17,88,42,10,32,31,10,8,11,16
372667,141,49,90,54,15,36,41,14,16,87,33,9,24,35,4,3,8,20,141,49,90,54,15,36,41,14,16,87,33,9,24,35,4,3,8,20
372668,133,39,90,43,17,49,34,31,36,86,56,9,47,24,9,8,12,23,133,39,90,43,17,49,34,31,36,86,56,9,47,24,9,8,12,23
372669,143,60,94,63,19,39,48,11,13,84,39,8,31,50,12,3,14,24,143,60,94,63,19,39,48,11,13,84,39,8,31,50,12,3,14,24
372671,137,41,77,53,16,33,48,16,23,69,52,12,40,31,9,1,23,19,137,41,77,53,16,33,48,16,23,69,52,12,40,31,9,1,23,19
372672,134,41,91,45,14,39,35,28,33,84,51,20,31,25,9,3,15,24,134,41,91,45,14,39,35,28,33,84,51,20,31,25,9,3,15,24
372670,154,33,81,40,6,23,26,20,27,74,38,8,30,22,8,9,14,18,154,33,81,40,6,23,26,20,27,74,38,8,30,22,8,9,14,18
372673,136,40,74,54,10,28,35,14,17,82,41,4,37,29,7,6,14,17,136,40,74,54,10,28,35,14,17,82,41,4,37,29,7,6,14,17
372674,142,36,90,40,12,32,37,11,15,73,38,7,31,18,7,2,15,15,142,36,90,40,12,32,37,11,15,73,38,7,31,18,7,2,15,15
372675,150,33,92,35,12,29,41,17,23,73,43,14,29,22,9,5,9,17,150,33,92,35,12,29,41,17,23,73,43,14,29,22,9,5,9,17
372676,138,56,96,58,17,38,44,10,15,66,52,10,42,35,11,8,17,21,138,56,96,58,17,38,44,10,15,66,52,10,42,35,11,8,17,21
372677,139,48,95,50,9,33,27,15,19,78,38,9,29,28,8,1,13,23,139,48,95,50,9,33,27,15,19,78,38,9,29,28,8,1,13,23
372678,155,44,87,50,14,35,40,11,17,64,44,9,35,30,13,5,9,18,155,44,87,50,14,35,40,11,17,64,44,9,35,30,13,5,9,18
372681,141,38,82,46,16,38,42,21,25,84,45,7,38,24,3,5,16,18,141,38,82,46,16,38,42,21,25,84,45,7,38,24,3,5,16,18
372679,157,52,100,52,21,38,55,10,15,66,42,11,31,35,4,1,14,23,157,52,100,52,21,38,55,10,15,66,42,11,31,35,4,1,14,23
372680,145,42,85,49,10,28,35,19,27,70,35,8,27,26,13,3,13,14,145,42,85,49,10,28,35,19,27,70,35,8,27,26,13,3,13,14
372683,161,40,85,47,13,37,35,12,20,60,45,12,33,33,5,3,20,20,161,40,85,47,13,37,35,12,20,60,45,12,33,33,5,3,20,20
372682,143,38,92,41,8,42,19,17,22,77,38,10,28,23,12,2,9,18,143,38,92,41,8,42,19,17,22,77,38,10,28,23,12,2,9,18
372684,154,42,104,40,7,38,18,18,23,78,34,15,19,30,12,6,6,20,154,42,104,40,7,38,18,18,23,78,34,15,19,30,12,6,6,20
372685,142,36,83,43,13,34,38,27,32,84,46,7,39,22,7,2,10,24,142,36,83,43,13,34,38,27,32,84,46,7,39,22,7,2,10,24
372686,137,43,88,48,16,43,37,15,21,71,44,12,32,27,6,3,16,16,137,43,88,48,16,43,37,15,21,71,44,12,32,27,6,3,16,16
372689,157,38,91,41,15,45,33,9,12,75,25,8,17,28,9,2,9,12,157,38,91,41,15,45,33,9,12,75,25,8,17,28,9,2,9,12
372690,138,43,95,45,15,40,37,14,20,70,44,15,29,20,7,8,11,19,138,43,95,45,15,40,37,14,20,70,44,15,29,20,7,8,11,19
372691,139,47,80,58,10,27,37,27,31,87,38,6,32,35,6,10,12,23,139,47,80,58,10,27,37,27,31,87,38,6,32,35,6,10,12,23
372692,155,46,102,45,8,28,28,15,22,68,50,16,34,29,5,6,12,27,155,46,102,45,8,28,28,15,22,68,50,16,34,29,5,6,12,27
372693,141,45,100,45,14,46,30,14,15,93,43,15,28,30,5,4,10,11,141,45,100,45,14,46,30,14,15,93,43,15,28,30,5,4,10,11
372694,145,42,82,51,11,29,37,11,16,68,40,8,32,23,9,6,19,11,145,42,82,51,11,29,37,11,16,68,40,8,32,23,9,6,19,11
372696,143,48,91,52,19,40,47,18,22,81,39,9,30,29,6,7,13,23,143,48,91,52,19,40,47,18,22,81,39,9,30,29,6,7,13,23
372697,161,44,89,49,15,32,46,25,29,86,38,12,26,32,7,5,14,23,161,44,89,49,15,32,46,25,29,86,38,12,26,32,7,5,14,23
372698,147,41,82,50,15,36,41,23,32,71,44,10,34,30,6,5,10,21,147,41,82,50,15,36,41,23,32,71,44,10,34,30,6,5,10,21
372699,148,42,94,44,17,36,47,15,19,78,38,11,27,31,6,6,9,20,148,42,94,44,17,36,47,15,19,78,38,11,27,31,6,6,9,20
372700,144,53,85,62,15,29,51,17,23,73,44,11,33,32,11,3,12,21,144,53,85,62,15,29,51,17,23,73,44,11,33,32,11,3,12,21
372701,140,40,85,47,14,37,37,16,21,76,40,13,27,27,12,2,21,19,140,40,85,47,14,37,37,16,21,76,40,13,27,27,12,2,21,19
372702,153,34,94,36,13,42,31,11,18,61,46,16,30,20,13,5,13,22,153,34,94,36,13,42,31,11,18,61,46,16,30,20,13,5,13,22
372703,151,37,89,41,18,48,37,20,23,87,55,15,40,26,11,4,15,16,151,37,89,41,18,48,37,20,23,87,55,15,40,26,11,4,15,16
372704,138,36,82,43,9,27,33,22,27,81,33,8,25,20,9,4,13,17,138,36,82,43,9,27,33,22,27,81,33,8,25,20,9,4,13,17
372705,145,44,81,54,16,36,44,28,36,77,39,5,34,34,6,4,15,16,145,44,81,54,16,36,44,28,36,77,39,5,34,34,6,4,15,16
372706,140,44,96,45,10,32,31,10,13,76,43,9,34,33,4,3,10,19,140,44,96,45,10,32,31,10,13,76,43,9,34,33,4,3,10,19
372707,143,41,92,44,8,25,32,22,24,91,54,14,40,31,7,6,14,22,143,41,92,44,8,25,32,22,24,91,54,14,40,31,7,6,14,22
372708,135,35,87,40,16,38,42,12,16,75,36,8,28,17,2,3,10,16,135,35,87,40,16,38,42,12,16,75,36,8,28,17,2,3,10,16
372711,147,41,89,46,15,36,41,23,28,82,38,8,30,25,8,3,10,13,147,41,89,46,15,36,41,23,28,82,38,8,30,25,8,3,10,13
372714,141,39,89,43,12,39,30,15,18,83,43,14,29,24,4,4,17,19,141,39,89,43,12,39,30,15,18,83,43,14,29,24,4,4,17,19
372713,160,46,83,55,13,33,39,19,23,82,40,7,33,34,12,8,17,19,160,46,83,55,13,33,39,19,23,82,40,7,33,34,12,8,17,19
372715,144,49,93,52,15,34,44,13,13,100,36,11,25,34,6,5,7,17,144,49,93,52,15,34,44,13,13,100,36,11,25,34,6,5,7,17
372716,137,32,82,39,13,44,29,34,43,79,47,12,35,16,11,6,11,24,137,32,82,39,13,44,29,34,43,79,47,12,35,16,11,6,11,24
372717,148,52,92,56,18,42,42,13,16,81,54,12,42,34,3,6,11,22,148,52,92,56,18,42,42,13,16,81,54,12,42,34,3,6,11,22
372718,152,53,93,57,14,35,40,19,22,86,59,8,51,41,6,8,13,10,152,53,93,57,14,35,40,19,22,86,59,8,51,41,6,8,13,10
372719,138,44,88,50,17,41,41,23,30,76,38,11,27,27,6,2,10,19,138,44,88,50,17,41,41,23,30,76,38,11,27,27,6,2,10,19
372720,145,40,80,50,13,34,38,16,25,64,37,7,30,33,8,4,18,19,145,40,80,50,13,34,38,16,25,64,37,7,30,33,8,4,18,19
372721,154,40,93,43,15,35,42,17,18,94,46,14,32,23,11,9,13,19,154,40,93,43,15,35,42,17,18,94,46,14,32,23,11,9,13,19
372722,132,40,89,44,11,30,36,17,23,73,28,12,16,25,14,2,14,13,132,40,89,44,11,30,36,17,23,73,28,12,16,25,14,2,14,13
372723,140,44,88,50,12,35,34,10,16,62,46,11,35,32,6,9,14,21,140,44,88,50,12,35,34,10,16,62,46,11,35,32,6,9,14,21
372730,158,45,87,51,18,38,47,27,34,79,45,7,38,31,9,7,14,20,158,45,87,51,18,38,47,27,34,79,45,7,38,31,9,7,14,20
372727,149,44,80,55,11,31,35,17,24,70,45,8,37,35,14,5,15,23,149,44,80,55,11,31,35,17,24,70,45,8,37,35,14,5,15,23
372725,146,41,95,43,18,44,40,19,27,70,46,17,29,30,5,4,9,21,146,41,95,43,18,44,40,19,27,70,46,17,29,30,5,4,9,21
372724,136,50,86,58,18,40,45,13,16,81,36,6,30,31,1,3,12,21,136,50,86,58,18,40,45,13,16,81,36,6,30,31,1,3,12,21
372726,147,37,83,44,8,26,30,17,20,85,41,12,29,23,6,1,16,17,147,37,83,44,8,26,30,17,20,85,41,12,29,23,6,1,16,17
372729,160,52,93,55,21,43,48,20,26,76,56,14,42,34,7,8,13,23,160,52,93,55,21,43,48,20,26,76,56,14,42,34,7,8,13,23
372728,139,50,90,55,14,33,42,11,15,73,48,10,38,30,5,4,15,18,139,50,90,55,14,33,42,11,15,73,48,10,38,30,5,4,15,18
372731,133,51,95,53,24,47,51,19,25,76,50,10,40,26,7,8,12,21,133,51,95,53,24,47,51,19,25,76,50,10,40,26,7,8,12,21
372732,132,32,93,34,11,40,27,24,33,72,50,16,34,21,9,7,16,20,132,32,93,34,11,40,27,24,33,72,50,16,34,21,9,7,16,20
372735,152,43,94,45,8,36,22,18,21,85,46,12,34,23,9,4,9,19,152,43,94,45,8,36,22,18,21,85,46,12,34,23,9,4,9,19
372733,146,36,87,41,9,38,23,13,15,86,35,9,26,27,14,5,12,16,146,36,87,41,9,38,23,13,15,86,35,9,26,27,14,5,12,16
372734,148,51,94,54,13,31,41,14,17,82,50,14,36,33,6,5,12,15,148,51,94,54,13,31,41,14,17,82,50,14,36,33,6,5,12,15
372737,138,37,82,45,15,41,36,19,20,95,34,9,25,23,6,1,12,25,138,37,82,45,15,41,36,19,20,95,34,9,25,23,6,1,12,25
372736,158,39,95,41,18,46,39,20,23,87,47,12,35,26,7,4,8,19,158,39,95,41,18,46,39,20,23,87,47,12,35,26,7,4,8,19
372738,160,42,93,45,12,37,32,36,39,92,52,13,39,28,7,5,10,20,160,42,93,45,12,37,32,36,39,92,52,13,39,28,7,5,10,20
372739,139,46,71,64,10,20,50,15,23,65,40,4,36,31,8,3,21,18,139,46,71,64,10,20,50,15,23,65,40,4,36,31,8,3,21,18
372740,147,40,81,49,11,25,44,13,16,81,44,4,40,27,6,6,14,15,147,40,81,49,11,25,44,13,16,81,44,4,40,27,6,6,14,15
372742,149,38,67,56,13,26,50,20,31,64,41,6,35,25,8,5,17,23,149,38,67,56,13,26,50,20,31,64,41,6,35,25,8,5,17,23
372743,156,40,89,44,20,42,47,16,22,72,36,12,24,23,8,1,13,21,156,40,89,44,20,42,47,16,22,72,36,12,24,23,8,1,13,21
372744,154,40,83,48,15,31,48,29,34,85,41,8,33,25,8,4,11,24,154,40,83,48,15,31,48,29,34,85,41,8,33,25,8,4,11,24
372745,138,39,85,45,18,43,41,29,35,82,42,13,29,24,4,6,12,29,138,39,85,45,18,43,41,29,35,82,42,13,29,24,4,6,12,29
372747,151,33,83,39,13,40,32,15,22,68,41,13,28,20,3,3,10,20,151,33,83,39,13,40,32,15,22,68,41,13,28,20,3,3,10,20
372746,161,44,95,46,19,41,46,10,11,90,33,8,25,30,8,7,8,19,161,44,95,46,19,41,46,10,11,90,33,8,25,30,8,7,8,19
372748,132,40,93,43,13,38,34,16,21,76,56,13,43,24,8,6,20,19,132,40,93,43,13,38,34,16,21,76,56,13,43,24,8,6,20,19
372749,146,32,86,37,20,54,37,32,40,80,42,11,31,24,13,10,13,12,146,32,86,37,20,54,37,32,40,80,42,11,31,24,13,10,13,12
372750,137,39,95,41,20,57,35,11,11,100,48,13,35,28,9,3,14,14,137,39,95,41,20,57,35,11,11,100,48,13,35,28,9,3,14,14
372752,159,38,95,40,4,32,12,16,21,76,52,9,43,25,6,2,7,21,159,38,95,40,4,32,12,16,21,76,52,9,43,25,6,2,7,21
372753,160,45,81,55,11,25,44,31,35,88,46,10,36,29,5,8,15,17,160,45,81,55,11,25,44,31,35,88,46,10,36,29,5,8,15,17
372754,145,44,84,52,8,24,33,16,18,88,44,8,36,30,7,9,17,12,145,44,84,52,8,24,33,16,18,88,44,8,36,30,7,9,17,12
372755,154,43,76,56,15,31,48,25,34,73,32,5,27,27,6,7,8,21,154,43,76,56,15,31,48,25,34,73,32,5,27,27,6,7,8,21
372756,155,42,85,49,17,37,45,18,20,90,46,8,38,32,7,6,20,15,155,42,85,49,17,37,45,18,20,90,46,8,38,32,7,6,20,15
372757,144,47,87,54,20,43,46,14,23,60,39,12,27,30,5,10,10,18,144,47,87,54,20,43,46,14,23,60,39,12,27,30,5,10,10,18
372758,140,46,89,51,12,31,38,13,19,68,40,8,32,30,4,7,12,18,140,46,89,51,12,31,38,13,19,68,40,8,32,30,4,7,12,18
372759,132,39,76,51,8,25,32,20,22,90,41,10,31,21,8,2,23,17,132,39,76,51,8,25,32,20,22,90,41,10,31,21,8,2,23,17
372760,133,42,90,46,18,38,47,15,19,78,54,12,42,22,5,6,14,15,133,42,90,46,18,38,47,15,19,78,54,12,42,22,5,6,14,15
372761,137,55,93,59,12,28,42,13,19,68,55,11,44,36,5,3,11,9,137,55,93,59,12,28,42,13,19,68,55,11,44,36,5,3,11,9
372762,151,39,87,44,13,37,35,18,22,81,51,12,39,24,6,5,15,20,151,39,87,44,13,37,35,18,22,81,51,12,39,24,6,5,15,20
372763,159,45,88,51,20,38,52,11,18,61,45,13,32,34,9,4,12,14,159,45,88,51,20,38,52,11,18,61,45,13,32,34,9,4,12,14
372764,150,44,88,50,25,47,53,19,23,82,50,16,34,32,11,3,13,14,150,44,88,50,25,47,53,19,23,82,50,16,34,32,11,3,13,14
372766,145,49,91,53,12,28,42,17,24,70,45,9,36,33,8,1,11,15,145,49,91,53,12,28,42,17,24,70,45,9,36,33,8,1,11,15
372767,156,42,86,48,9,27,33,12,14,85,41,10,31,21,2,2,13,16,156,42,86,48,9,27,33,12,14,85,41,10,31,21,2,2,13,16
372769,159,42,83,50,10,38,26,16,20,80,38,7,31,31,7,5,14,18,159,42,83,50,10,38,26,16,20,80,38,7,31,31,7,5,14,18
372768,151,39,86,45,13,38,34,22,26,84,47,7,40,22,6,5,17,18,151,39,86,45,13,38,34,22,26,84,47,7,40,22,6,5,17,18
372770,160,43,89,48,13,32,40,30,36,83,38,11,27,33,7,4,15,21,160,43,89,48,13,32,40,30,36,83,38,11,27,33,7,4,15,21
372771,149,45,82,54,12,28,42,16,21,76,39,6,33,30,8,9,15,13,149,45,82,54,12,28,42,16,21,76,39,6,33,30,8,9,15,13
372772,157,44,85,51,15,37,40,18,32,56,38,8,30,27,7,6,11,20,157,44,85,51,15,37,40,18,32,56,38,8,30,27,7,6,11,20
372773,135,47,84,56,16,29,55,14,16,87,40,10,30,25,9,4,18,16,135,47,84,56,16,29,55,14,16,87,40,10,30,25,9,4,18,16
372774,153,37,78,47,10,23,43,25,27,92,36,11,25,24,3,5,16,23,153,37,78,47,10,23,43,25,27,92,36,11,25,24,3,5,16,23
372775,133,38,89,42,14,44,31,10,14,71,38,12,26,21,5,2,2,17,133,38,89,42,14,44,31,10,14,71,38,12,26,21,5,2,2,17
372776,147,38,82,46,12,31,38,20,22,90,44,13,31,21,7,2,18,17,147,38,82,46,12,31,38,20,22,90,44,13,31,21,7,2,18,17
372777,150,41,93,44,10,42,23,17,23,73,42,9,33,27,4,5,11,16,150,41,93,44,10,42,23,17,23,73,42,9,33,27,4,5,11,16
372779,156,42,84,50,4,12,33,30,35,85,47,9,38,18,3,11,11,21,156,42,84,50,4,12,33,30,35,85,47,9,38,18,3,11,11,21
372780,145,40,90,44,12,33,36,20,24,83,44,10,34,31,7,3,14,11,145,40,90,44,12,33,36,20,24,83,44,10,34,31,7,3,14,11
372781,140,44,94,46,21,37,56,26,32,81,40,9,31,30,6,2,8,30,140,44,94,46,21,37,56,26,32,81,40,9,31,30,6,2,8,30
372782,135,35,85,41,9,37,24,10,14,71,47,7,40,23,2,7,16,20,135,35,85,41,9,37,24,10,14,71,47,7,40,23,2,7,16,20
372783,161,49,103,47,9,29,31,20,23,87,46,14,32,28,10,4,11,21,161,49,103,47,9,29,31,20,23,87,46,14,32,28,10,4,11,21
372784,151,48,88,54,14,39,35,16,20,80,61,15,46,27,4,7,21,20,151,48,88,54,14,39,35,16,20,80,61,15,46,27,4,7,21,20
372785,132,37,93,39,11,38,28,10,15,66,45,11,34,25,5,4,11,15,132,37,93,39,11,38,28,10,15,66,45,11,34,25,5,4,11,15
372786,136,47,91,51,14,33,42,17,21,81,52,13,39,32,11,5,11,18,136,47,91,51,14,33,42,17,21,81,52,13,39,32,11,5,11,18
372788,149,31,75,41,14,37,37,21,29,72,50,9,41,22,4,7,21,26,149,31,75,41,14,37,37,21,29,72,50,9,41,22,4,7,21,26
372789,144,42,83,50,13,26,50,28,33,84,45,8,37,26,6,5,11,18,144,42,83,50,13,26,50,28,33,84,45,8,37,26,6,5,11,18
372790,153,37,78,47,9,28,32,22,28,78,44,12,32,21,5,5,14,16,153,37,78,47,9,28,32,22,28,78,44,12,32,21,5,5,14,16
372791,161,39,91,42,8,27,29,18,22,81,40,12,28,31,6,9,13,23,161,39,91,42,8,27,29,18,22,81,40,12,28,31,6,9,13,23
372792,142,41,94,43,10,35,28,15,22,68,49,11,38,26,9,3,15,17,142,41,94,43,10,35,28,15,22,68,49,11,38,26,9,3,15,17
372793,155,47,82,57,8,25,32,15,18,83,44,6,38,25,7,5,16,24,155,47,82,57,8,25,32,15,18,83,44,6,38,25,7,5,16,24
372794,145,47,86,54,13,33,39,27,29,93,45,10,35,28,9,6,14,18,145,47,86,54,13,33,39,27,29,93,45,10,35,28,9,6,14,18
372795,140,40,89,44,10,30,33,23,29,79,42,6,36,25,4,9,10,25,140,40,89,44,10,30,33,23,29,79,42,6,36,25,4,9,10,25
372796,153,34,74,45,11,29,37,20,30,66,34,8,26,25,7,0,15,17,153,34,74,45,11,29,37,20,30,66,34,8,26,25,7,0,15,17
372797,154,48,97,49,5,20,25,32,40,80,48,19,29,28,5,3,4,20,154,48,97,49,5,20,25,32,40,80,48,19,29,28,5,3,4,20
372798,159,35,79,44,8,23,34,22,23,95,47,12,35,31,7,8,17,14,159,35,79,44,8,23,34,22,23,95,47,12,35,31,7,8,17,14
372799,149,44,84,52,18,41,43,19,25,76,36,6,30,34,4,1,13,15,149,44,84,52,18,41,43,19,25,76,36,6,30,34,4,1,13,15
372800,138,43,97,44,14,40,35,10,14,71,48,10,38,24,4,4,10,20,138,43,97,44,14,40,35,10,14,71,48,10,38,24,4,4,10,20
372801,155,44,85,51,14,34,41,13,17,76,39,5,34,32,5,5,7,13,155,44,85,51,14,34,41,13,17,76,39,5,34,32,5,5,7,13
372802,157,43,93,46,12,38,31,24,27,88,51,10,41,22,8,2,9,21,157,43,93,46,12,38,31,24,27,88,51,10,41,22,8,2,9,21
372803,143,43,87,49,5,21,23,18,21,85,38,7,31,24,4,1,10,16,143,43,87,49,5,21,23,18,21,85,38,7,31,24,4,1,10,16
372804,134,42,95,44,15,42,35,4,5,80,40,13,27,29,7,5,13,19,134,42,95,44,15,42,35,4,5,80,40,13,27,29,7,5,13,19
372805,150,60,104,57,23,46,50,10,15,66,57,12,45,41,6,4,9,24,150,60,104,57,23,46,50,10,15,66,57,12,45,41,6,4,9,24
372806,152,43,89,48,7,23,30,18,28,64,43,10,33,23,9,10,12,18,152,43,89,48,7,23,30,18,28,64,43,10,33,23,9,10,12,18
372807,144,52,88,59,14,27,51,9,12,75,36,6,30,33,8,5,14,17,144,52,88,59,14,27,51,9,12,75,36,6,30,33,8,5,14,17
372808,140,43,86,50,15,38,39,12,20,60,44,5,39,26,4,0,11,17,140,43,86,50,15,38,39,12,20,60,44,5,39,26,4,0,11,17
372809,161,37,77,48,10,24,41,23,29,79,49,7,42,31,2,3,21,22,161,37,77,48,10,24,41,23,29,79,49,7,42,31,2,3,21,22
372810,147,33,82,40,11,34,32,19,25,76,44,11,33,21,9,9,17,17,147,33,82,40,11,34,32,19,25,76,44,11,33,21,9,9,17,17
372812,148,45,90,50,11,29,37,25,28,89,46,10,36,24,9,3,12,16,148,45,90,50,11,29,37,25,28,89,46,10,36,24,9,3,12,16
372814,138,41,89,46,17,43,39,10,18,55,33,10,23,25,4,3,14,16,138,41,89,46,17,43,39,10,18,55,33,10,23,25,4,3,14,16
372811,158,43,86,50,9,32,28,19,25,76,38,12,26,30,7,11,19,14,158,43,86,50,9,32,28,19,25,76,38,12,26,30,7,11,19,14
372815,141,51,91,56,16,33,48,16,22,72,49,11,38,26,6,9,10,18,141,51,91,56,16,33,48,16,22,72,49,11,38,26,6,9,10,18
372816,143,53,93,57,12,28,42,16,21,76,55,12,43,35,6,8,21,33,143,53,93,57,12,28,42,16,21,76,55,12,43,35,6,8,21,33
372817,161,43,88,48,7,30,23,15,20,75,35,5,30,33,11,7,11,14,161,43,88,48,7,30,23,15,20,75,35,5,30,33,11,7,11,14
372818,134,35,77,45,10,33,30,14,16,87,32,5,27,22,7,3,13,15,134,35,77,45,10,33,30,14,16,87,32,5,27,22,7,3,13,15
372819,147,42,94,44,16,42,38,10,13,76,31,11,20,25,7,1,4,12,147,42,94,44,16,42,38,10,13,76,31,11,20,25,7,1,4,12
372820,151,45,85,52,15,38,39,17,20,85,44,12,32,26,12,3,8,14,151,45,85,52,15,38,39,17,20,85,44,12,32,26,12,3,8,14
372821,141,48,86,55,19,37,51,18,23,78,33,6,27,30,7,3,13,19,141,48,86,55,19,37,51,18,23,78,33,6,27,30,7,3,13,19
372822,145,53,87,60,20,31,64,15,20,75,30,5,25,35,10,4,12,21,145,53,87,60,20,31,64,15,20,75,30,5,25,35,10,4,12,21
372825,143,58,109,53,8,26,30,9,15,60,48,21,27,34,8,3,12,17,143,58,109,53,8,26,30,9,15,60,48,21,27,34,8,3,12,17
372823,132,51,97,52,15,34,44,26,30,86,36,12,24,32,7,2,7,24,132,51,97,52,15,34,44,26,30,86,36,12,24,32,7,2,7,24
372824,135,35,85,41,9,29,31,25,32,78,32,5,27,20,6,7,13,25,135,35,85,41,9,29,31,25,32,78,32,5,27,20,6,7,13,25
372826,159,44,96,45,6,32,18,13,22,59,45,15,30,26,6,3,11,18,159,44,96,45,6,32,18,13,22,59,45,15,30,26,6,3,11,18
372827,146,42,90,46,15,41,36,8,13,61,43,9,34,30,9,7,14,21,146,42,90,46,15,41,36,8,13,61,43,9,34,30,9,7,14,21
372828,148,35,87,40,13,34,38,17,24,70,51,12,39,21,6,4,18,24,148,35,87,40,13,34,38,17,24,70,51,12,39,21,6,4,18,24
372829,150,32,82,39,9,36,25,10,14,71,41,8,33,24,9,5,20,16,150,32,82,39,9,36,25,10,14,71,41,8,33,24,9,5,20,16
372830,158,42,92,45,10,34,29,22,26,84,59,17,42,30,12,5,18,11,158,42,92,45,10,34,29,22,26,84,59,17,42,30,12,5,18,11
372831,140,37,85,43,9,32,28,21,27,77,45,11,34,22,2,8,17,20,140,37,85,43,9,32,28,21,27,77,45,11,34,22,2,8,17,20
372832,151,45,87,51,17,33,51,18,26,69,46,11,35,25,6,3,7,15,151,45,87,51,17,33,51,18,26,69,46,11,35,25,6,3,7,15
372833,139,37,82,45,13,37,35,24,38,63,44,13,31,25,5,3,7,15,139,37,82,45,13,37,35,24,38,63,44,13,31,25,5,3,7,15
372834,134,36,74,48,12,34,35,22,37,59,40,2,38,24,11,6,19,22,134,36,74,48,12,34,35,22,37,59,40,2,38,24,11,6,19,22
372835,133,36,100,36,10,40,25,14,16,87,52,18,34,21,2,9,11,13,133,36,100,36,10,40,25,14,16,87,52,18,34,21,2,9,11,13
372836,135,47,92,51,13,32,40,15,21,71,35,9,26,35,7,6,10,22,135,47,92,51,13,32,40,15,21,71,35,9,26,35,7,6,10,22
372837,148,51,91,56,20,45,44,19,25,76,45,6,39,30,12,0,9,25,148,51,91,56,20,45,44,19,25,76,45,6,39,30,12,0,9,25
372839,158,46,84,54,13,30,43,8,15,53,39,14,25,35,7,7,15,14,158,46,84,54,13,30,43,8,15,53,39,14,25,35,7,7,15,14
372840,138,43,98,43,16,46,34,13,18,72,43,13,30,35,7,2,10,24,138,43,98,43,16,46,34,13,18,72,43,13,30,35,7,2,10,24
372843,140,47,95,49,11,26,42,15,19,78,53,15,38,27,6,2,9,11,140,47,95,49,11,26,42,15,19,78,53,15,38,27,6,2,9,11
372841,143,44,90,48,13,35,37,15,16,93,44,11,33,31,8,6,10,26,143,44,90,48,13,35,37,15,16,93,44,11,33,31,8,6,10,26
372844,153,41,92,44,12,36,33,19,26,73,40,11,29,30,12,7,7,21,153,41,92,44,12,36,33,19,26,73,40,11,29,30,12,7,7,21
372842,132,44,95,46,6,27,22,32,40,80,51,20,31,27,7,4,14,21,132,44,95,46,6,27,22,32,40,80,51,20,31,27,7,4,14,21
372845,156,32,79,40,6,33,18,26,29,89,48,7,41,22,2,5,14,21,156,32,79,40,6,33,18,26,29,89,48,7,41,22,2,5,14,21
372846,135,37,81,45,11,32,34,7,14,50,41,9,32,23,4,6,14,14,135,37,81,45,11,32,34,7,14,50,41,9,32,23,4,6,14,14
372847,137,42,86,48,13,40,32,21,26,80,46,11,35,28,6,3,13,18,137,42,86,48,13,40,32,21,26,80,46,11,35,28,6,3,13,18
372848,147,33,84,39,14,36,38,25,25,100,44,8,36,20,5,5,11,18,147,33,84,39,14,36,38,25,25,100,44,8,36,20,5,5,11,18
372849,134,54,105,51,21,45,46,18,19,94,50,16,34,41,12,9,8,24,134,54,105,51,21,45,46,18,19,94,50,16,34,41,12,9,8,24
372850,133,43,85,50,17,46,37,15,20,75,40,6,34,27,7,5,11,15,133,43,85,50,17,46,37,15,20,75,40,6,34,27,7,5,11,15
372853,152,35,79,44,14,35,40,17,22,77,38,8,30,21,5,7,12,17,152,35,79,44,14,35,40,17,22,77,38,8,30,21,5,7,12,17
372851,142,52,98,53,12,36,33,19,25,76,56,14,42,36,10,2,15,19,142,52,98,53,12,36,33,19,25,76,56,14,42,36,10,2,15,19
372852,146,30,80,37,13,36,36,21,28,75,37,9,28,22,11,1,14,16,146,30,80,37,13,36,36,21,28,75,37,9,28,22,11,1,14,16
372854,158,43,92,46,12,30,40,15,17,88,36,10,26,31,10,7,14,17,158,43,92,46,12,30,40,15,17,88,36,10,26,31,10,7,14,17
372855,138,43,69,62,13,27,48,32,43,74,35,3,32,27,6,2,15,24,138,43,69,62,13,27,48,32,43,74,35,3,32,27,6,2,15,24
372856,139,44,91,48,4,18,22,21,24,87,47,9,38,29,7,4,8,22,139,44,91,48,4,18,22,21,24,87,47,9,38,29,7,4,8,22
372857,156,46,84,54,12,28,42,26,29,89,39,11,28,29,7,5,13,24,156,46,84,54,12,28,42,26,29,89,39,11,28,29,7,5,13,24
372858,151,44,94,46,13,34,38,17,18,94,45,14,31,29,9,7,5,16,151,44,94,46,13,34,38,17,18,94,45,14,31,29,9,7,5,16
372859,133,47,87,54,17,36,47,18,22,81,40,7,33,25,6,9,10,16,133,47,87,54,17,36,47,18,22,81,40,7,33,25,6,9,10,16
372860,132,53,101,52,16,38,42,16,18,88,46,12,34,32,10,2,12,18,132,53,101,52,16,38,42,16,18,88,46,12,34,32,10,2,12,18
372861,136,38,75,50,11,32,34,20,27,74,33,6,27,21,9,9,17,16,136,38,75,50,11,32,34,20,27,74,33,6,27,21,9,9,17,16
372862,141,44,79,55,14,32,43,17,19,89,42,8,34,32,6,6,16,20,141,44,79,55,14,32,43,17,19,89,42,8,34,32,6,6,16,20
372863,135,40,90,44,16,46,34,14,17,82,40,9,31,25,4,7,9,18,135,40,90,44,16,46,34,14,17,82,40,9,31,25,4,7,9,18
372864,137,47,89,52,12,35,34,22,23,95,33,10,23,26,13,5,9,15,137,47,89,52,12,35,34,22,23,95,33,10,23,26,13,5,9,15
372865,161,45,97,46,9,29,31,10,15,66,45,12,33,19,4,10,13,19,161,45,97,46,9,29,31,10,15,66,45,12,33,19,4,10,13,19
372867,147,42,84,50,13,28,46,18,23,78,49,7,42,38,3,2,8,16,147,42,84,50,13,28,46,18,23,78,49,7,42,38,3,2,8,16
372868,158,36,80,45,9,31,29,17,24,70,41,7,34,24,9,9,17,20,158,36,80,45,9,31,29,17,24,70,41,7,34,24,9,9,17,20
372869,142,35,87,40,13,44,29,16,17,94,29,5,24,19,11,2,5,21,142,35,87,40,13,44,29,16,17,94,29,5,24,19,11,2,5,21
372870,149,45,80,56,13,30,43,18,30,60,45,9,36,31,6,5,10,24,149,45,80,56,13,30,43,18,30,60,45,9,36,31,6,5,10,24
372871,152,37,87,42,11,26,42,20,25,80,53,15,38,24,2,9,11,14,152,37,87,42,11,26,42,20,25,80,53,15,38,24,2,9,11,14
372866,134,47,94,50,16,39,41,10,13,76,27,8,19,28,11,1,11,24,134,47,94,50,16,39,41,10,13,76,27,8,19,28,11,1,11,24
372872,156,49,92,53,12,28,42,9,9,100,39,9,30,26,9,1,11,20,156,49,92,53,12,28,42,9,9,100,39,9,30,26,9,1,11,20
372873,133,41,97,42,16,48,33,7,7,100,54,14,40,30,4,12,15,19,133,41,97,42,16,48,33,7,7,100,54,14,40,30,4,12,15,19
372874,151,41,103,39,8,38,21,19,25,76,60,24,36,15,8,7,10,14,151,41,103,39,8,38,21,19,25,76,60,24,36,15,8,7,10,14
372876,146,37,90,41,12,38,31,15,17,88,43,7,36,25,9,12,13,19,146,37,90,41,12,38,31,15,17,88,43,7,36,25,9,12,13,19
372875,160,45,87,51,12,36,33,22,25,88,43,10,33,36,3,9,11,15,160,45,87,51,12,36,33,22,25,88,43,10,33,36,3,9,11,15
372878,140,45,89,50,17,40,42,18,24,75,38,13,25,28,5,3,16,18,140,45,89,50,17,40,42,18,24,75,38,13,25,28,5,3,16,18
372877,161,37,90,41,11,42,26,17,21,81,43,6,37,28,5,4,8,25,161,37,90,41,11,42,26,17,21,81,43,6,37,28,5,4,8,25
372879,132,49,95,51,17,44,38,14,18,77,43,12,31,29,7,4,9,13,132,49,95,51,17,44,38,14,18,77,43,12,31,29,7,4,9,13
372880,143,46,85,54,10,29,34,20,24,83,39,8,31,23,13,3,22,20,143,46,85,54,10,29,34,20,24,83,39,8,31,23,13,3,22,20
372881,142,55,93,59,11,31,35,14,17,82,49,7,42,30,9,3,14,20,142,55,93,59,11,31,35,14,17,82,49,7,42,30,9,3,14,20
372882,146,35,87,40,14,46,30,17,24,70,37,9,28,30,7,4,13,20,146,35,87,40,14,46,30,17,24,70,37,9,28,30,7,4,13,20
372883,149,38,82,46,12,38,31,18,20,90,38,6,32,24,8,5,17,20,149,38,82,46,12,38,31,18,20,90,38,6,32,24,8,5,17,20
372884,152,44,75,58,17,36,47,21,27,77,44,3,41,31,10,10,16,17,152,44,75,58,17,36,47,21,27,77,44,3,41,31,10,10,16,17
372885,158,46,96,47,10,39,25,11,18,61,55,18,37,35,6,10,18,16,158,46,96,47,10,39,25,11,18,61,55,18,37,35,6,10,18,16
372886,139,46,91,50,12,36,33,16,17,94,48,16,32,34,3,6,11,20,139,46,91,50,12,36,33,16,17,94,48,16,32,34,3,6,11,20
372887,154,44,96,45,12,29,41,21,27,77,44,11,33,26,7,1,5,17,154,44,96,45,12,29,41,21,27,77,44,11,33,26,7,1,5,17
372889,136,42,91,46,11,34,32,20,22,90,47,11,36,24,13,3,16,20,136,42,91,46,11,34,32,20,22,90,47,11,36,24,13,3,16,20
372890,138,40,81,49,16,39,41,21,23,91,42,8,34,22,9,1,21,19,138,40,81,49,16,39,41,21,23,91,42,8,34,22,9,1,21,19
372891,151,41,100,41,10,35,28,13,15,86,51,18,33,21,1,4,7,20,151,41,100,41,10,35,28,13,15,86,51,18,33,21,1,4,7,20
372892,158,36,98,36,12,40,30,17,21,81,54,14,40,23,6,6,12,13,158,36,98,36,12,40,30,17,21,81,54,14,40,23,6,6,12,13
372893,140,36,80,45,8,31,25,19,22,86,36,9,27,22,6,5,15,18,140,36,80,45,8,31,25,19,22,86,36,9,27,22,6,5,15,18
372894,161,47,96,49,7,32,21,11,17,64,35,13,22,32,11,4,18,19,161,47,96,49,7,32,21,11,17,64,35,13,22,32,11,4,18,19
372895,147,38,91,41,8,30,26,11,12,91,45,12,33,24,9,0,10,19,147,38,91,41,8,30,26,11,12,91,45,12,33,24,9,0,10,19
372896,135,35,88,39,8,29,27,21,25,84,43,11,32,18,6,5,11,16,135,35,88,39,8,29,27,21,25,84,43,11,32,18,6,5,11,16
372897,133,48,99,48,19,51,37,16,18,88,57,17,40,30,11,4,11,13,133,48,99,48,19,51,37,16,18,88,57,17,40,30,11,4,11,13
372898,149,40,90,44,11,30,36,20,27,74,58,11,47,21,6,11,16,19,149,40,90,44,11,30,36,20,27,74,58,11,47,21,6,11,16,19
372900,160,43,89,48,17,44,38,20,24,83,52,12,40,31,3,3,16,24,160,43,89,48,17,44,38,20,24,83,52,12,40,31,3,3,16,24
372901,139,42,86,48,12,28,42,16,19,84,42,14,28,26,8,6,8,11,139,42,86,48,12,28,42,16,19,84,42,14,28,26,8,6,8,11
372902,135,47,96,49,13,32,40,11,14,78,34,5,29,26,9,1,9,16,135,47,96,49,13,32,40,11,14,78,34,5,29,26,9,1,9,16
372903,137,51,88,58,23,41,56,11,17,64,45,5,40,36,10,5,9,15,137,51,88,58,23,41,56,11,17,64,45,5,40,36,10,5,9,15
372904,154,40,93,43,8,29,27,14,20,70,51,16,35,20,8,5,12,21,154,40,93,43,8,29,27,14,20,70,51,16,35,20,8,5,12,21
372905,134,34,89,38,13,42,31,17,22,77,38,11,27,23,7,12,10,23,134,34,89,38,13,42,31,17,22,77,38,11,27,23,7,12,10,23
372906,132,51,95,53,20,39,51,22,27,81,39,13,26,35,5,4,11,22,132,51,95,53,20,39,51,22,27,81,39,13,26,35,5,4,11,22
372907,150,53,104,51,19,45,42,13,13,100,51,17,34,36,11,5,7,13,150,53,104,51,19,45,42,13,13,100,51,17,34,36,11,5,7,13
372908,143,54,86,62,15,32,46,9,14,64,25,5,20,35,7,7,12,20,143,54,86,62,15,32,46,9,14,64,25,5,20,35,7,7,12,20
372911,151,48,86,55,11,27,40,16,20,80,36,8,28,28,13,5,10,12,151,48,86,55,11,27,40,16,20,80,36,8,28,28,13,5,10,12
372909,134,41,91,45,12,33,36,13,15,86,43,8,35,33,6,5,10,13,134,41,91,45,12,33,36,13,15,86,43,8,35,33,6,5,10,13
372910,147,47,87,54,13,36,36,14,18,77,45,11,34,31,10,3,13,19,147,47,87,54,13,36,36,14,18,77,45,11,34,31,10,3,13,19
372913,160,46,89,51,14,35,40,18,20,90,48,15,33,29,9,8,17,17,160,46,89,51,14,35,40,18,20,90,48,15,33,29,9,8,17,17
372914,155,44,87,50,8,28,28,18,27,66,49,8,41,17,8,5,14,19,155,44,87,50,8,28,28,18,27,66,49,8,41,17,8,5,14,19
372916,135,44,90,48,16,39,41,13,20,65,38,9,29,27,6,2,10,20,135,44,90,48,16,39,41,13,20,65,38,9,29,27,6,2,10,20
372915,161,42,94,44,16,40,40,6,9,66,47,12,35,27,10,5,15,23,161,42,94,44,16,40,40,6,9,66,47,12,35,27,10,5,15,23
372918,133,49,93,52,17,49,34,10,11,90,45,6,39,33,6,9,14,16,133,49,93,52,17,49,34,10,11,90,45,6,39,33,6,9,14,16
372919,147,43,87,49,12,38,31,18,23,78,45,5,40,29,8,2,11,20,147,43,87,49,12,38,31,18,23,78,45,5,40,29,8,2,11,20
372917,154,41,98,41,8,32,25,14,14,100,40,11,29,21,7,8,15,16,154,41,98,41,8,32,25,14,14,100,40,11,29,21,7,8,15,16
372921,157,45,95,47,15,44,34,15,22,68,33,5,28,31,7,6,4,20,157,45,95,47,15,44,34,15,22,68,33,5,28,31,7,6,4,20
372920,144,36,78,46,12,32,37,22,26,84,37,8,29,23,7,2,19,17,144,36,78,46,12,32,37,22,26,84,37,8,29,23,7,2,19,17
372922,143,39,81,48,12,31,38,19,27,70,30,7,23,31,11,6,14,17,143,39,81,48,12,31,38,19,27,70,30,7,23,31,11,6,14,17
372923,153,49,82,59,16,27,59,13,20,65,39,8,31,34,11,5,17,20,153,49,82,59,16,27,59,13,20,65,39,8,31,34,11,5,17,20
372924,151,42,94,44,14,37,37,10,11,90,46,14,32,27,5,2,14,19,151,42,94,44,14,37,37,10,11,90,46,14,32,27,5,2,14,19
372925,134,37,93,39,10,25,40,11,14,78,34,12,22,22,9,3,12,17,134,37,93,39,10,25,40,11,14,78,34,12,22,22,9,3,12,17
372926,146,42,91,46,18,46,39,8,13,61,34,9,25,26,8,4,10,24,146,42,91,46,18,46,39,8,13,61,34,9,25,26,8,4,10,24
372927,148,40,81,49,14,33,42,11,16,68,35,10,25,35,6,3,13,10,148,40,81,49,14,33,42,11,16,68,35,10,25,35,6,3,13,10
372928,155,52,88,59,14,29,48,11,16,68,37,5,32,37,10,7,12,22,155,52,88,59,14,29,48,11,16,68,37,5,32,37,10,7,12,22
372929,145,41,89,46,8,25,32,16,22,72,39,10,29,27,12,10,7,10,145,41,89,46,8,25,32,16,22,72,39,10,29,27,12,10,7,10
372931,154,42,98,42,15,45,33,22,29,75,49,18,31,24,7,6,10,24,154,42,98,42,15,45,33,22,29,75,49,18,31,24,7,6,10,24
372932,133,48,92,52,11,34,32,26,28,92,49,9,40,25,9,5,13,17,133,48,92,52,11,34,32,26,28,92,49,9,40,25,9,5,13,17
372933,159,40,95,42,10,33,30,17,19,89,41,16,25,24,14,8,11,17,159,40,95,42,10,33,30,17,19,89,41,16,25,24,14,8,11,17
372934,148,41,94,43,18,52,34,20,24,83,53,10,43,26,8,5,7,24,148,41,94,43,18,52,34,20,24,83,53,10,43,26,8,5,7,24
372935,157,51,87,58,17,34,50,16,18,88,42,6,36,32,11,1,16,22,157,51,87,58,17,34,50,16,18,88,42,6,36,32,11,1,16,22
372936,145,49,88,55,14,31,45,27,32,84,32,5,27,32,5,5,8,20,145,49,88,55,14,31,45,27,32,84,32,5,27,32,5,5,8,20
372937,138,53,91,58,15,38,39,25,33,75,54,11,43,30,8,3,12,23,138,53,91,58,15,38,39,25,33,75,54,11,43,30,8,3,12,23
372938,144,37,82,45,13,39,33,25,26,96,35,0,35,20,9,6,11,13,144,37,82,45,13,39,33,25,26,96,35,0,35,20,9,6,11,13
372939,134,49,87,56,17,34,50,8,11,72,41,9,32,31,8,7,12,23,134,49,87,56,17,34,50,8,11,72,41,9,32,31,8,7,12,23
372942,161,42,86,48,13,35,37,16,21,76,39,7,32,28,7,8,17,23,161,42,86,48,13,35,37,16,21,76,39,7,32,28,7,8,17,23
372940,135,47,82,57,16,31,51,5,7,71,43,5,38,30,8,4,19,9,135,47,82,57,16,31,51,5,7,71,43,5,38,30,8,4,19,9
372943,159,35,87,40,9,31,29,16,23,69,40,12,28,22,7,3,11,14,159,35,87,40,9,31,29,16,23,69,40,12,28,22,7,3,11,14
372944,132,40,88,45,14,41,34,28,37,75,41,9,32,25,7,8,11,18,132,40,88,45,14,41,34,28,37,75,41,9,32,25,7,8,11,18
372945,151,40,84,47,10,32,31,21,23,91,32,5,27,16,7,4,9,15,151,40,84,47,10,32,31,21,23,91,32,5,27,16,7,4,9,15
372946,141,45,101,44,17,41,41,6,11,54,52,13,39,33,6,2,14,20,141,45,101,44,17,41,41,6,11,54,52,13,39,33,6,2,14,20
372947,156,33,76,43,6,21,28,12,17,70,42,11,31,19,7,4,18,14,156,33,76,43,6,21,28,12,17,70,42,11,31,19,7,4,18,14
372948,147,40,97,41,12,40,30,14,15,93,45,14,31,21,4,2,7,14,147,40,97,41,12,40,30,14,15,93,45,14,31,21,4,2,7,14
372949,152,46,85,54,13,27,48,22,27,81,36,5,31,30,8,9,11,17,152,46,85,54,13,27,48,22,27,81,36,5,31,30,8,9,11,17
372951,137,44,92,47,13,37,35,20,25,80,43,15,28,33,6,8,11,17,137,44,92,47,13,37,35,20,25,80,43,15,28,33,6,8,11,17
372950,135,44,82,53,10,34,29,13,16,81,46,5,41,27,5,3,19,17,135,44,82,53,10,34,29,13,16,81,46,5,41,27,5,3,19,17
372952,159,39,98,39,8,31,25,13,16,81,47,16,31,25,11,4,19,20,159,39,98,39,8,31,25,13,16,81,47,16,31,25,11,4,19,20
372953,132,44,94,46,14,43,32,24,29,82,49,15,34,33,4,3,12,20,132,44,94,46,14,43,32,24,29,82,49,15,34,33,4,3,12,20
372954,142,36,80,45,10,26,38,23,33,69,39,12,27,22,12,3,12,16,142,36,80,45,10,26,38,23,33,69,39,12,27,22,12,3,12,16
372955,146,34,81,42,12,44,27,7,8,87,36,3,33,28,7,8,18,17,146,34,81,42,12,44,27,7,8,87,36,3,33,28,7,8,18,17
372956,148,42,84,50,16,34,47,12,18,66,51,9,42,30,8,6,13,19,148,42,84,50,16,34,47,12,18,66,51,9,42,30,8,6,13,19
372957,138,43,96,44,9,36,25,17,26,65,56,12,44,27,7,12,16,18,138,43,96,44,9,36,25,17,26,65,56,12,44,27,7,12,16,18
372958,160,41,92,44,11,32,34,14,16,87,44,9,35,23,8,7,17,17,160,41,92,44,11,32,34,14,16,87,44,9,35,23,8,7,17,17
372959,144,34,84,40,9,28,32,23,26,88,36,10,26,20,6,3,13,14,144,34,84,40,9,28,32,23,26,88,36,10,26,20,6,3,13,14
372960,134,39,79,49,15,33,45,17,26,65,37,7,30,28,6,3,12,21,134,39,79,49,15,33,45,17,26,65,37,7,30,28,6,3,12,21
372961,153,41,91,45,11,36,30,20,25,80,48,14,34,29,6,3,16,19,153,41,91,45,11,36,30,20,25,80,48,14,34,29,6,3,16,19
372962,148,37,83,44,13,39,33,10,11,90,38,5,33,24,8,4,18,12,148,37,83,44,13,39,33,10,11,90,38,5,33,24,8,4,18,12
372964,156,39,87,44,11,29,37,20,25,80,44,12,32,26,5,1,16,29,156,39,87,44,11,29,37,20,25,80,44,12,32,26,5,1,16,29
372963,155,44,85,51,13,31,41,29,36,80,39,7,32,29,11,6,12,16,155,44,85,51,13,31,41,29,36,80,39,7,32,29,11,6,12,16
372965,145,43,84,51,14,35,40,25,30,83,47,7,40,32,6,11,16,14,145,43,84,51,14,35,40,25,30,83,47,7,40,32,6,11,16,14
372966,135,44,89,49,15,37,40,19,20,95,46,12,34,27,7,4,13,18,135,44,89,49,15,37,40,19,20,95,46,12,34,27,7,4,13,18
372967,153,48,76,63,12,26,46,10,11,90,34,7,27,25,7,7,12,22,153,48,76,63,12,26,46,10,11,90,34,7,27,25,7,7,12,22
372968,154,41,86,47,10,35,28,12,16,75,39,6,33,29,3,1,14,20,154,41,86,47,10,35,28,12,16,75,39,6,33,29,3,1,14,20
372969,159,50,98,51,6,26,23,19,26,73,56,15,41,30,6,7,15,20,159,50,98,51,6,26,23,19,26,73,56,15,41,30,6,7,15,20
372970,137,40,83,48,12,37,32,16,21,76,36,6,30,31,6,2,8,18,137,40,83,48,12,37,32,16,21,76,36,6,30,31,6,2,8,18
372971,133,52,91,57,22,45,48,10,12,83,51,10,41,32,6,5,10,13,133,52,91,57,22,45,48,10,12,83,51,10,41,32,6,5,10,13
372972,146,39,79,49,15,35,42,28,41,68,46,8,38,27,8,11,11,20,146,39,79,49,15,35,42,28,41,68,46,8,38,27,8,11,11,20
372973,150,50,89,56,10,32,31,23,29,79,39,8,31,36,14,6,10,21,150,50,89,56,10,32,31,23,29,79,39,8,31,36,14,6,10,21
372974,138,49,92,53,11,30,36,7,10,70,55,8,47,28,6,9,15,14,138,49,92,53,11,30,36,7,10,70,55,8,47,28,6,9,15,14
372975,139,35,89,39,9,26,34,19,22,86,45,12,33,27,6,5,12,18,139,35,89,39,9,26,34,19,22,86,45,12,33,27,6,5,12,18
372976,155,35,77,45,10,31,32,36,44,81,54,9,45,28,15,11,23,20,155,35,77,45,10,31,32,36,44,81,54,9,45,28,15,11,23,20
372977,160,49,101,48,14,45,31,10,13,76,44,15,29,29,5,7,13,21,160,49,101,48,14,45,31,10,13,76,44,15,29,29,5,7,13,21
372978,141,47,103,45,18,47,38,13,18,72,47,13,34,34,7,2,9,25,141,47,103,45,18,47,38,13,18,72,47,13,34,34,7,2,9,25
372979,146,44,83,53,13,26,50,12,19,63,40,7,33,30,9,3,16,16,146,44,83,53,13,26,50,12,19,63,40,7,33,30,9,3,16,16
372765,160,43,93,46,22,49,44,29,32,90,48,17,31,33,10,3,16,22,160,43,93,46,22,49,44,29,32,90,48,17,31,33,10,3,16,22
372980,156,31,83,37,8,29,27,21,30,70,35,9,26,18,8,5,15,23,156,31,83,37,8,29,27,21,30,70,35,9,26,18,8,5,15,23
387445,1416,83,146,56,42,97,43,3,4,75,64,24,40,46,6,1,14,1,1416,83,146,56,42,97,43,3,4,75,64,24,40,46,6,1,14,1
372984,159,41,84,48,14,31,45,25,30,83,45,7,38,24,10,6,11,18,159,41,84,48,14,31,45,25,30,83,45,7,38,24,10,6,11,18
372983,154,37,84,44,10,29,34,12,14,85,38,7,31,23,7,3,18,23,154,37,84,44,10,29,34,12,14,85,38,7,31,23,7,3,18,23
372981,137,39,70,55,10,22,45,21,26,80,33,7,26,31,8,5,19,18,137,39,70,55,10,22,45,21,26,80,33,7,26,31,8,5,19,18
372982,143,50,94,53,13,30,43,16,19,84,42,7,35,36,10,5,14,15,143,50,94,53,13,30,43,16,19,84,42,7,35,36,10,5,14,15
372985,138,43,90,47,19,44,43,18,21,85,39,10,29,24,10,5,10,21,138,43,90,47,19,44,43,18,21,85,39,10,29,24,10,5,10,21
372986,136,44,94,46,10,28,35,14,16,87,45,13,32,30,6,2,13,17,136,44,94,46,10,28,35,14,16,87,45,13,32,30,6,2,13,17
372987,150,50,96,52,16,41,39,11,18,61,43,9,34,35,16,6,14,21,150,50,96,52,16,41,39,11,18,61,43,9,34,35,16,6,14,21
372988,152,50,90,55,17,35,48,12,17,70,44,8,36,24,9,11,15,16,152,50,90,55,17,35,48,12,17,70,44,8,36,24,9,11,15,16
372989,160,37,86,43,9,39,23,24,27,88,54,15,39,26,3,2,19,21,160,37,86,43,9,39,23,24,27,88,54,15,39,26,3,2,19,21
372990,139,56,101,55,7,31,22,11,15,73,60,13,47,41,11,11,16,16,139,56,101,55,7,31,22,11,15,73,60,13,47,41,11,11,16,16
372992,141,50,107,46,16,41,39,12,14,85,48,15,33,32,6,4,9,19,141,50,107,46,16,41,39,12,14,85,48,15,33,32,6,4,9,19
372991,157,52,93,55,13,33,39,10,14,71,42,7,35,29,5,6,10,12,157,52,93,55,13,33,39,10,14,71,42,7,35,29,5,6,10,12
372994,154,40,90,44,12,29,41,12,15,80,51,9,42,20,6,7,9,25,154,40,90,44,12,29,41,12,15,80,51,9,42,20,6,7,9,25
372993,132,46,106,43,12,39,30,17,24,70,54,20,34,27,5,4,9,11,132,46,106,43,12,39,30,17,24,70,54,20,34,27,5,4,9,11
372995,142,37,93,39,15,45,33,25,34,73,54,17,37,25,8,5,14,23,142,37,93,39,15,45,33,25,34,73,54,17,37,25,8,5,14,23
372996,146,38,91,41,8,35,22,11,16,68,41,14,27,26,12,3,12,17,146,38,91,41,8,35,22,11,16,68,41,14,27,26,12,3,12,17
372998,152,55,92,59,20,40,50,17,21,81,56,8,48,30,5,9,15,22,152,55,92,59,20,40,50,17,21,81,56,8,48,30,5,9,15,22
373001,150,39,104,37,7,32,21,10,13,76,54,18,36,20,6,7,11,19,150,39,104,37,7,32,21,10,13,76,54,18,36,20,6,7,11,19
372997,149,43,98,43,13,35,37,8,13,61,52,16,36,23,8,4,13,18,149,43,98,43,13,35,37,8,13,61,52,16,36,23,8,4,13,18
372999,156,46,101,45,8,25,32,12,18,66,45,19,26,25,11,2,10,17,156,46,101,45,8,25,32,12,18,66,45,19,26,25,11,2,10,17
373000,141,38,89,42,13,42,31,8,10,80,53,13,40,28,7,7,21,15,141,38,89,42,13,42,31,8,10,80,53,13,40,28,7,7,21,15
